1(asz)	NU	c
1(asz)	NU	one
1(ban)	N	unit
1(barig)	N	unit
1(bariga)	N	unit
1(bur'u)	N	unit
1(bur)	N	unit
1(disz)	NU	unit
1(disz)	NU	one
1(esze)	N	unit
1(gesz'u)	NU	six_hundred
1(gesz)	NU	sixty
1(iku)	N	unit
1(szar)	N	unit
1(u)	NU	ten
1/2(disz)	NU	one
1/2(iku)	N	unit
1/3(disz)	NU	one
1/4(iku)	N	unit
2(asz)	NU	one
2(ban)	N	unit
2(bariga)	N	unit
2(bur)	N	unit
2(disz	NU	t)
2(disz)	NU	one
2(esze)	N	unit
2(gesz'u)	NU	six_hundred
2(gesz)	NU	sixty
2(iku)	N	unit
2(u)	NU	ten
2/3(disz)	NU	one
3(asz)	NU	one
3(ban)	N	unit
3(bariga)	N	unit
3(bur'u)	N	unit
3(bur)	N	unit
3(disz	NU	t)
3(disz)	NU	3(disz)
3(disz)	NU	one
3(gesz'u)	NU	six_hundred
3(gesz)	NU	sixty
3(iku)	N	unit
3(u)	NU	ten
4(asz)	NU	one
4(ban)	N	unit
4(bariga)	N	unit
4(bur'u)	N	unit
4(bur)	N	unit
4(disz)	NU	one
4(gesz'u)	NU	six_hundred
4(gesz)	NU	sixty
4(iku)	N	unit
4(u)	NU	ten
5(asz)	NU	one
5(ban)	N	unit
5(bur)	N	unit
5(disz)	NU	one
5(gesz'u)	NU	six_hundred
5(gesz)	NU	sixty
5(iku)	N	unit
5(u)	NU	ten
5/6(disz)	NU	one
6(asz)	NU	one
6(bur)	N	unit
6(disz)	NU	one
6(gesz)	NU	sixty
7(asz)	NU	one
7(disz)	NU	one
7(gesz)	NU	sixty
8(asz)	NU	one
8(bur)	N	unit
8(disz)	NU	one
8(gesz2)	NU	sixty
9(asz)	NU	one
9(bur)	N	unit
9(disz)	NU	one
9(gesz)	NU	sixty
A'anda	DN	A'anda
A'annati	PN	A'annati
A'uda	FN	A'uda
Aba	PN	Aba
Aba'enlilgin	PN	Aba'enlilgin
Abala	FN	Abala
Abaszaragin	PN	Abaszaragin
Abbagina	PN	Abbagina
Abbakala	PN	Abbakala
Abbamu	PN	Abbamu
Abbasaga	PN	Abbasaga
Abilati	PN	Abilati
Abillatum	PN	Abillatum
Abilsuen	PN	Abilsuen
Abisimti	PN	Abisimti
Abuda	PN	Abuda
Abuka	FN	Abuka
Abuni	PN	Abuni
Adaga	PN	Adaga
Adalal	PN	Adalal
Adaszen	PN	Adaszen
Adda	PN	Adda
Addada	PN	Addada
Addakala	PN	Addakala
Addamu	PN	Addamu
Adu	PN	Adu
Adudu	PN	Adudu
Adumu	PN	Adumu
Agalzi	PN	Agalzi
Agiwum	ON	Agiwum
Agu	PN	Agu
Agu'a	PN	Agu'a
Agugu	PN	Agugu
Ahu'aga	PN	Ahu'aga
Ahuni	PN	Ahuni
Ahuwaqar	PN	Ahuwaqar
Ahuwer	PN	Ahuwer
Ahuya	PN	Ahuya
Akala	PN	Akala
Akiti	MN	Akiti
Akuku	PN	Akuku
Ala	PN	Ala
Alamusz	DN	Alamusz
Ali	PN	Ali
Alla	PN	Alla
Allagula	DN	Allagula
Allamu	PN	Allamu
Allapalil	PN	Allapalil
Allatum	DN	Allatum
Alulu	PN	Alulu
Ama	PN	emahe
Amagina	PN	Amagina
Amakala	PN	Amakala
Amamaya	PN	Amamaya
Amarayasi	MN	Amarayasi
Amarkiszi	PN	Amarkiszi
Amarsuen	RN	Amarsuen
Amawurszage	PN	Amawurszage
Ambar	SN	Ambar
Amma	PN	Amma
Amurdingir	PN	Amurdingir
Amurutu	PN	Amurutu
An	DN	An
Anamu	PN	Anamu
Andagudu'eszeki'ag	PN	Andagudu'eszeki'ag
Aneni	PN	Aneni
Angugumu	PN	Angugumu
Anita	PN	Anita
Annahilibi	PN	Annahilibi
Anne	PN	Anne
Annebabdu	PN	Annebabdu
Annunitum	PN	Annunitum
Anszan	GN	Anszan
Anzubabbar	TN	Anzubabbar
Apidingir	PN	Apidingir
Apindu'a	MN	Apindu'a
Apisal	FN	Apisal
Arad	PN	Arad
Aradam	PN	Aradam
Aradhula	PN	Aradhula
Aradmu	PN	Aradmu
Aradnanna	PN	Aradnanna
Aradszara	PN	Aradszara
Arsziah	PN	Arsziah
Arti'a	PN	Arti'a
Aszi'an	PN	Aszi'an
Ata	PN	Ata
Atu	PN	Atu
Ayabbamu	PN	Ayabbamu
Ayabbani	PN	Ayabbani
Ayakala	PN	Ayakala
Ayalni	PN	Ayalni
Ayamu	PN	Ayamu
Ayatti'a	PN	Ayatti'a
Azida	PN	Azida
Baba	PN	Baba
Babati	PN	Babati
Baddari	PN	Baddari
Badirina	PN	Badirina
Bahanszer	PN	Bahanszer
Bala	PN	Bala
Bali	PN	Bali
Balu	N	Balu
Bamu	PN	Bamu
Basa	PN	Basa
Basaga	PN	Basaga
Bayabalum	PN	Bayabalum
Bayaga	PN	Bayaga
Bayansa	PN	Bayansa
Bazi	PN	Bazi
Belatdarraban	DN	Belatdarraban
Belatsuhner	DN	Belatsuhner
Beli	PN	azu
Belidu	PN	Belidu
Bibi	PN	Bibi
Bibi'a	PN	Bibi'a
Biduga	PN	Biduga
Bikkinum	PN	Bikkinum
Bilga	PN	Bilga
Bu'unum	PN	Bu'unum
Bubu	PN	Bubu
Bugati	PN	Bugati
Burmama	PN	Burmama
DIRI	PN	tum
Da'umma	SN	Da'umma
Dada	PN	Dada
Dadaga	PN	Dadaga
Dadani	PN	Dadani
Dadaya	PN	Dadaya
Dadu	PN	Dadu
Dadumu	PN	Dadumu
Dagamu	PN	Dagamu
Dagi	PN	Dagi
Dal	MN	Dal
Dalbana	FN	Dalbana
Damsa	PN	Damsa
Damu	PN	Damu
Danni'a	PN	Danni'a
Dannum	PN	Dannum
Danu'a	PN	Danu'a
Danupi	PN	Danupi
Dayagi	PN	Dayagi
Der	SN	Der
Dikumiszar	PN	Dikumiszar
Dingira	PN	Dingira
Dingiradah	PN	Dingiradah
Dingirbani	PN	Dingirbani
Dingirga'isa	PN	Dingirga'isa
Dingirra	PN	Dingirra
Dingirrabi	PN	Dingirrabi
Dingirsudan	PN	Dingirsudan
Dingirsurabi	PN	Dingirsurabi
Du'udu	PN	Du'udu
Dudu	SN	Dudu
Duga	PN	Duga
Dugamu	PN	Dugamu
Dugani	PN	Dugani
Duge	PN	Duge
Dukusig	FN	Dukusig
Dumuzi	MN	Dumuzi
Duru	FN	Duru
Durul	WN	Durul
Durunannagugal	FN	Durunannagugal
E'abani	PN	E'abani
E'ansze	FN	E'ansze
E'erdingir	PN	E'erdingir
E'iluruguda	PN	E'iluruguda
E'iti6	MN	E'iti6
E'u'e	PN	E'u'e
E'u15	TN	E'u15
E'u7	ON	E'u7
E'urbidu	PN	E'urbidu
Ea	ON	Ea
Eana	TN	Eana
Ebabbar	TN	Ebabbar
Ebkusza	PN	Ebkusza
Edi	PN	Edi
Egalesi	PN	Egalesi
Egesztin	PN	Egesztin
Egibile	FN	Egibile
Ekigal	PN	Ekigal
Ekikkengibil	GN	Ekikkengibil
Elakkuruba	PN	Elakkuruba
Elaknu'id	PN	Elaknu'id
Elam	EN	Elam
Elam	GN	Elam
Elanu'id	PN	Elanu'id
Elubisu	PN	Elubisu
Eludan	PN	Eludan
Elulagar	PN	Elulagar
Emah	TN	Emah
Emakidug	PN	Emakidug
Enamgalanna	PN	Enamgalanna
Endimgi	SN	Endimgi
Endingirmu	PN	Endingirmu
Enegi	SN	Enegi
Engalmahana	PN	Engalmahana
Enki	DN	Enki
Enkik	DN	Enkik
Enlil	DN	Enlil
Enlila	PN	Enlila
Enlilmu	PN	Enlilmu
Enmahgalana	PN	Enmahgalana
Enmahganna	SN	Enmahganna
Ennirgalanna	PN	Ennirgalanna
Ennu	PN	Ennu
Ennunki	PN	Ennunki
Ennunne	PN	Ennunne
Enrakal	PN	Enrakal
Enumiszkur	PN	Enumiszkur
Enunugal	PN	Enunugal
Enunugalinanna	PN	Enunugalinanna
Enurkuge	PN	Enurkuge
Era'ursag	PN	Era'ursag
Erabani	PN	Erabani
Erabi	PN	Erabi
Ereszum	PN	Ereszum
Eridug	SN	Eridug
Erinda	PN	Erinda
Erradan	PN	Erradan
Erragar	PN	Erragar
Erreb	PN	Erreb
Errebum	PN	Errebum
Erzudan	PN	Erzudan
Esarradu	SN	Esarradu
Eszara	TN	Eszara
Etena	GN	Etena
Ezemanna	MN	Ezemanna
Ezembaba	MN	Ezembaba
Ezemdumuzi	MN	Ezemdumuzi
Ezemlisi	MN	Ezemlisi
Ezemlisina	MN	Ezemlisina
Ezemmah	MN	Ezemmah
Ezemmekigal	MN	Ezemmekigal
Ezemninazu	MN	Ezemninazu
Ezemszulgir	MN	Ezemszulgir
GANAgud	FN	GANAgud
GANmah	FN	GANmah
GANmasz	MN	GANmasz
Ga'esz	SN	Ga'esz
Gadu	PN	Gadu
Gaduszana'um	PN	Gaduszana'um
Gamu	PN	Gamu
Gani	SN	Gani
Ganmasz	MN	Ganmasz
Garszana	SN	Garszana
Gayagagaya	PN	Gayagagaya
Gayagaya	PN	Gayagaya
Gayame	PN	Gayame
Geme	PN	aszar
Geme	PN	asznan
Geme	PN	ebgal
Geme	PN	enlilla
Geme	PN	isztaran
Geme'aszar	PN	Geme'aszar
Geme'igalim	PN	Geme'igalim
Gemedubla	PN	Gemedubla
Gemedumuzida	PN	Gemedumuzida
Gemegigir	PN	Gemegigir
Gemelisi	PN	Gemelisi
Gemenigar	PN	Gemenigar
Gemesuen	PN	Gemesuen
Gemeszara	PN	Gemeszara
Gemeszulpa	PN	e
Geparkidu	PN	Geparkidu
Geszgibanda	FN	Geszgibanda
Geszirminra	PN	Geszirminra
Gezal	DN	Gezal
Gi'apinkudra	FN	Gi'apinkudra
Gibilka'isa	PN	Gibilka'isa
Gidaha	FN	Gidaha
Gigire	PN	Gigire
Gine	PN	Gine
Ginuna	PN	Ginuna
Giribaba	PN	idab
Girini	PN	Girini
Girini'idab	PN	Girini'idab
Girini'isa	PN	Girini'isa
Girsu	SN	Girsu
Gu	AN	edina
Gu'abba	SN	Gu'abba
Gu'edina	SN	Gu'edina
Gu'ugu'a	PN	Gu'ugu'a
Gude'a	PN	Gude'a
Gudena	PN	Gudena
Gududu	PN	Gududu
Gugad	PN	Gugad
Gula	DN	Gula
Gululu	PN	Gululu
Gurabimumu	MN	Gurabimumu
Guratir	PN	Guratir
Gusuhub	FN	Gusuhub
Gutabimumu	MN	Gutabimumu
Guzani	PN	Guzani
Guzayana	PN	Guzayana
Ha'ia	DN	Ha'ia
Hababatum	PN	Hababatum
Habaluge	PN	Habaluge
Hala	PN	Hala
Halli'a	PN	Halli'a
Hamati	PN	Hamati
Hanzabtum	PN	Hanzabtum
Harszi	SN	Harszi
Haszipatal	PN	Haszipatal
Hemadu	PN	Hemadu
Hendursag	DN	Hendursag
Hesa	PN	Hesa
Heti	PN	Heti
Hibaritum	SN	Hibaritum
Huba	PN	Huba
Huh	SN	Huh
Huhnuri	SN	Huhnuri
Huhunuri	SN	Huhunuri
Hulal	PN	Hulal
Hunhurti	PN	Hunhurti
Hunnarum	PN	Hunnarum
Hurbiszam	PN	Hurbiszam
Hurti	SN	Hurti
Huwawa	PN	Huwawa
Ibbisuen	RN	Ibbisuen
Ibi	RN	Suen
Ibniszulgir	PN	Ibniszulgir
Idda'a	PN	Idda'a
Iddaya	PN	Iddaya
Idi'a	PN	Idi'a
Idi'iszkur	PN	Idi'iszkur
Ididingir	PN	Ididingir
Idigna	WN	Idigna
Idinerra	PN	Idinerra
Igbidingir	PN	Igbidingir
Igi	PN	insasa
Igidar	PN	Igidar
Igigallugaluru	SN	Igigallugaluru
Igigirnimu	PN	Igigirnimu
Igisasa	PN	Igisasa
Igisusu	PN	Igisusu
Igiszarasze	PN	Igiszarasze
Ikala	PN	Ikala
Ili'ahum	PN	Ili'ahum
Ili'etu	PN	Ili'etu
Iline	PN	Iline
Ilisa	PN	Ilisa
Inanna	DN	Inanna
Inaszum	PN	Inaszum
Indada	PN	Indada
Inimanizi	PN	Inimanizi
Iniminanna	PN	Iniminanna
Inimmadingir	PN	Inimmadingir
Inimszara	PN	Inimszara
Inimzuharakal	PN	Inimzuharakal
Insasa	PN	Insasa
Inta'e'a	PN	Inta'e'a
Inxx	PN	Inxx
Ipa'e	PN	Ipa'e
Iribare	PN	Iribare
Irisagrig	SN	Irisagrig
Isalla	SN	Isalla
Isin	SN	Isin
Iszarpadan	PN	Iszarpadan
Iszibene	FN	Iszibene
Iszkurbani	PN	Iszkurbani
Iszkurillat	PN	Iszkurillat
Iszkurkugal	PN	Iszkurkugal
Iszsu	SN	Iszsu
Isztaran	DN	Isztaran
KA	N	flour
Kage	PN	Kage
Kaguru	PN	Kaguru
Kala	PN	Kala
Kalamu	PN	Kalamu
Kamari	FN	Kamari
Karkinna	SN	Karkinna
Karzida	SN	Karzida
Kas	PN	Kas
Kaszuba	GN	Kaszuba
Katar	PN	Katar
Katul	FN	Katul
Kaya	PN	Kaya
Kaya	SN	Kaya
Kayamu	PN	Kayamu
Kazallu	SN	Kazallu
Ki'an	SN	Ki'an
Kibad	FN	Kibad
Kilula	PN	Kilula
Kimadasalla	SN	Kimadasalla
Kimasz	SN	Kimasz
Kina	PN	Kina
Kinunir	SN	Kinunir
Kira	SN	Kira
Kirsi'ak	MN	Kirsi'ak
Kisikil	PN	Kisikil
Kisikininazu	MN	Kisikininazu
Kisuen	SN	Kisuen
Kisura	N	border
Kituszlu	PN	Kituszlu
Kubatum	PN	Kubatum
Kudadu	PN	Kudadu
Kudamu	PN	Kudamu
Kudanum	PN	Kudanum
Kugani	PN	Kugani
Kugnanna	PN	Kugnanna
Kugninura	PN	Kugninura
Kuli	PN	Kuli
Kunansze	PN	Kunansze
Kuni	PN	Kuni
Kuramu	PN	Kuramu
Kuranisa	PN	Kuranisa
Kurbilak	PN	Kurbilak
Kusaga	PN	Kusaga
Kuza	PN	Kuza
Lagasz	SN	Lagasz
Lagip	PN	Lagip
Lalmes	PN	Lalmes
Lamah	FN	Lamah
Lamamu	PN	Lamamu
Lana	PN	Lana
Lani	PN	Lani
Lanimu	PN	Lanimu
Latur	FN	Latur
Layamu	PN	Layamu
Layasa	PN	Layasa
Laz	DN	Laz
Libursimti	PN	Libursimti
Liburszulgir	PN	Liburszulgir
Lila	PN	Lila
Lisi	MN	Lisi
Liszena	PN	Liszena
Lu'abu	PN	Lu'abu
Lu'ebgal	PN	Lu'ebgal
Lu'enlila	PN	Lu'enlila
Lu'igi	PN	Lu'igi
Lu'igimasze	PN	Lu'igimasze
Lu'igisasa	PN	Lu'igisasa
Lu'inanna	PN	Lu'inanna
Lu'irisag	PN	Lu'irisag
Lu'irisagki	PN	Lu'irisagki
Lu'ume	PN	Lu'ume
Lu'uru	PN	Lu'uru
Lu'utu	PN	Lu'utu
Lubaba	PN	Lubaba
Lubagara	PN	Lubagara
Lubalasa	PN	Lubalasa
Lubanda	PN	Lubanda
Ludamu	PN	Ludamu
Ludingira	PN	Ludingira
Luduga	PN	Luduga
Luga	PN	Luga
Lugalamgal	PN	Lugalamgal
Lugalamu	PN	Lugalamu
Lugalandul	PN	Lugalandul
Lugalanisa	PN	Lugalanisa
Lugalazida	PN	Lugalazida
Lugalbad	PN	Lugalbad
Lugalbanda	DN	Lugalbanda
Lugaldingira	PN	Lugaldingira
Lugaldubla	PN	Lugaldubla
Lugalebansa	PN	Lugalebansa
Lugalemahe	PN	Lugalemahe
Lugalengardu	PN	Lugalengardu
Lugalennun	PN	Lugalennun
Lugalezem	PN	Lugalezem
Lugalgaba	PN	Lugalgaba
Lugalgigire	PN	Lugalgigire
Lugalgumah	PN	Lugalgumah
Lugalhamati	PN	Lugalhamati
Lugalhegal	PN	Lugalhegal
Lugalhili	PN	Lugalhili
Lugalibila	PN	Lugalibila
Lugalidi	PN	Lugalidi
Lugaligihusz	PN	Lugaligihusz
Lugalinimduga	PN	Lugalinimduga
Lugalinimgina	PN	Lugalinimgina
Lugalirida	PN	Lugalirida
Lugalisa	PN	Lugalisa
Lugalitida	PN	Lugalitida
Lugalkigala	PN	Lugalkigala
Lugalkiri	PN	Lugalkiri
Lugalkisal	PN	Lugalkisal
Lugalkugani	PN	Lugalkugani
Lugalkuzu	PN	Lugalkuzu
Lugallama	PN	Lugallama
Lugallusasa	PN	Lugallusasa
Lugalmagure	PN	Lugalmagure
Lugalmassu	PN	Lugalmassu
Lugalmaszzu	PN	Lugalmaszzu
Lugalme	PN	Lugalme
Lugalme'a	PN	Lugalme'a
Lugalmeduga	PN	Lugalmeduga
Lugalmelam	PN	Lugalmelam
Lugalmudra	PN	Lugalmudra
Lugalmumag	PN	Lugalmumag
Lugalnesage	PN	Lugalnesage
Lugalniglagare	PN	Lugalniglagare
Lugalnignesage	PN	Lugalnignesage
Lugalnimah	PN	Lugalnimah
Lugalnir	PN	Lugalnir
Lugalpa	PN	e
Lugalsa'izu	PN	Lugalsa'izu
Lugalsaga	PN	Lugalsaga
Lugalsine'e	PN	Lugalsine'e
Lugalsisa	PN	Lugalsisa
Lugalszudari	PN	Lugalszudari
Lugalukkene	PN	Lugalukkene
Lugaluri	PN	Lugaluri
Lugaluszumgal	PN	Lugaluszumgal
Lugaluszur	PN	Lugaluszur
Lugalutu	PN	Lugalutu
Lugalzage	PN	Lugalzage
Lugalzagesi	PN	Lugalzagesi
Lugina	PN	Lugina
Lugirizal	PN	Lugirizal
Lugirsu	PN	Lugirsu
Lugugal	PN	Lugugal
Lugula	PN	Lugula
Luha'ia	PN	Luha'ia
Luhabilum	PN	Luhabilum
Luhegal	PN	Luhegal
Luhendursag	PN	Luhendursag
Luhurim	PN	Luhurim
Lukala	PN	Lukala
Lukurkala	PN	Lukurkala
Lukurkalla	PN	Lukurkalla
Lulu	PN	Lulu
Lulubu	SN	Lulubu
Lulubum	SN	Lulubum
Lumagure	PN	Lumagure
Lumelam	PN	Lumelam
Luna	PN	Luna
Lunanna	PN	Lunanna
Lunansze	PN	Lunansze
Lunigin	PN	Lunigin
Luniglagare	PN	Luniglagare
Lunindara	PN	Lunindara
Luningaka	PN	Luningaka
Luningirsu	PN	Luningirsu
Luninildama	PN	Luninildama
Luninszubur	PN	Luninszubur
Luninura	PN	Luninura
Lupada	PN	Lupada
Lusa'izu	PN	Lusa'izu
Lusaga	PN	Lusaga
Lusu	PN	Lusu
Lusuen	PN	Lusuen
Lusukkalankak	PN	Lusukkalankak
Luszalim	PN	Luszalim
Luszara	PN	Luszara
Luszulgir	PN	Luszulgir
Luturtur	PN	Luturtur
Luyenlil	PN	Luyenlil
Luzabala	PN	Luzabala
Madaga	SN	Madaga
Madara'abzu	ON	Madara'abzu
Madaya	PN	Madaya
Magure	PN	Magure
Mamihilisu	PN	Mamihilisu
Manba	PN	Manba
Manszum	PN	Manszum
Marhaszi	SN	Marhaszi
Martu	EN	Martu
Martu	N	Martu
Maszdagu	MN	Maszdagu
Maszdagula	PN	Maszdagula
Maszgula	PN	Maszgula
Maszkan	SN	Maszkan
Maszkanszabra	SN	Maszkanszabra
Maszkanuszure	SN	Maszkanuszure
Maszkugu	MN	Maszkugu
Maszum	PN	Maszum
Matilum	PN	Matilum
Me	PN	egalta
Me	PN	ezita
Me'isztaran	PN	Me'isztaran
Meniku	PN	Meniku
Menkar	FN	Menkar
Mepa'e	PN	Mepa'e
Mese	PN	Mese
Meslamta'e'a	PN	Meslamta'e'a
Minesz	MN	Minesz
Mudasa	PN	Mudasa
Munasi	PN	Munasi
Munugu	MN	Munugu
Munussaga	PN	Munussaga
Muri'anabak	SN	Muri'anabak
Muriqtidnim	ON	Muriqtidnim
Muru	FN	Muru
Muszbi'anna	FN	Muszbi'anna
Muszudu	MN	Muszudu
Nabasa	PN	Nabasa
Nabax	PN	Nabax
Nadatum	PN	Nadatum
Nakiki	PN	Nakiki
Nalu	PN	Nalu
Nalul	PN	Nalul
Namhani	PN	Namhani
Namirina	PN	Namirina
Namlugalidu	PN	Namlugalidu
Nammah	PN	Nammah
Namninanidu	PN	Namninanidu
Nanaya	DN	Nanaya
Nani	PN	Nani
Nanna	DN	Nanna
Nannagugal	WN	Nannagugal
Nannahegal	PN	Nannahegal
Nannahili	PN	Nannahili
Nannakam	PN	Nannakam
Nannaki'ag	N	Nannaki'ag
Nannaludu	PN	Nannaludu
Nannamaba	PN	Nannamaba
Nannazi	PN	Nannazi
Nansze	DN	Nansze
Nanszegarra	DN	Nanszegarra
Narame'a	PN	Narame'a
Naramili	PN	Naramili
Naramsuen	RN	Naramsuen
Narnita	PN	Narnita
Nasa	PN	Nasa
Nasilim	PN	Nasilim
Neduhuli	SN	Neduhuli
Nerahagal	DN	Nerahagal
Nesag	MN	Nesag
Nibru	SN	Nibru
Nigarkidu	PN	Nigarkidu
Nigbaba	PN	Nigbaba
Nigdu	PN	Nigdu
Nigdugani	PN	Nigdugani
Nigin	SN	Nigin
Niginszedu	WN	Niginszedu
Nigkala	PN	Nigkala
Niglagare	PN	Niglagare
Nigurum	PN	Nigurum
Nimgirane	PN	Nimgirane
Nimgirdide	PN	Nimgirdide
Nimgirdine	PN	Nimgirdine
Nimgirinimgina	PN	Nimgirinimgina
Nimgirszakuszanna	PN	Nimgirszakuszanna
Ninadda	PN	Ninadda
Ninagrigzi	PN	Ninagrigzi
Ninazu	DN	Ninazu
Ninbatukuszemduga	PN	Ninbatukuszemduga
Nindingir	PN	Nindingir
Ninebayansa	PN	Ninebayansa
Ninegal	DN	Ninegal
Ninegale	PN	Ninegale
Ninegi'a	DN	Ninegi'a
Ninensa	PN	Ninensa
Ninga	PN	Ninga
Ningal	DN	Ningal
Ningeszkimzi	PN	Ningeszkimzi
Ningeszzida	DN	Ningeszzida
Ningina	PN	Ningina
Ningubalag	DN	Ningubalag
Ninhedu	PN	Ninhedu
Ninhursag	DN	Ninhursag
Ninhursagak	DN	Ninhursagak
Ninilduma	PN	Ninilduma
Nininimgina	PN	Nininimgina
Ninkala	PN	Ninkala
Ninkuli	PN	Ninkuli
Ninkunun	TN	Ninkunun
Ninkurma	PN	Ninkurma
Ninkusig	PN	Ninkusig
Ninkuzu	PN	Ninkuzu
Ninlil	DN	Ninlil
Ninmagurre	PN	Ninmagurre
Ninmar	SN	Ninmar
Ninme	PN	a
Ninmelam	PN	Ninmelam
Ninnammahzu	PN	Ninnammahzu
Ninnudu	FN	Ninnudu
Ninsun	DN	Ninsun
Ninszagepada	DN	Ninszagepada
Ninszubur	DN	Ninszubur
Ninti'uga	DN	Ninti'uga
Ninturturra	PN	Ninturturra
Ninura	DN	Ninura
Ninurta	DN	Ninurta
Ninzagesi	PN	Ninzagesi
Niridagal	PN	Niridagal
Nitasaga	PN	Nitasaga
Nuhidingir	PN	Nuhidingir
Nuhilum	PN	Nuhilum
Nuraya	PN	Nuraya
Nurili	PN	Nurili
Nusku	DN	Nusku
Pa'u'e	MN	Pa'u'e
Pada	PN	Pada
Puttuli'um	SN	Puttuli'um
Puzuraszur	PN	Puzuraszur
Puzurdagan	SN	Puzurdagan
Puzurenlil	PN	Puzurenlil
Puzurenlila	PN	Puzurenlila
Puzureszdar	PN	Puzureszdar
Puzurgaga	PN	Puzurgaga
Puzurili	PN	Puzurili
Puzuriszdagan	SN	Puzuriszdagan
Puzuriszkur	PN	Puzuriszkur
Puzurnanna	PN	Puzurnanna
Puzurninkarak	PN	Puzurninkarak
Puzursuen	PN	Puzursuen
SI'Aya	PN	SI'Aya
SIGa	PN	SIGa
SZIM	N	beer_malt
SZU	N	bread_type
Sa'a	ON	Sa'a
Sabum	SN	Sabum
Sagazak	SN	Sagazak
Sagdana	PN	Sagdana
Sagine	PN	Sagine
Sagku	PN	Sagku
Sagnannazu	PN	Sagnannazu
Sagub	SN	Sagub
Saharu'u	SN	Saharu'u
Sallesa	FN	Sallesa
Sesdagu	MN	Sesdagu
Siga	MN	Siga
Sigara	PN	Sigara
Sigarha	PN	Sigarha
Sigga	MN	Sigga
Sigiszubbagar	MN	Sigiszubbagar
Sigiszubgar	MN	Sigiszubgar
Sigtelani	PN	Sigtelani
Siguszubagar	MN	Siguszubagar
Simanum	SN	Simanum
Simurrum	SN	Simurrum
Simurum	SN	Simurum
Siram	PN	Siram
Sisa	WN	Sisa
Sisini	PN	Sisini
Su'enbani	PN	Su'enbani
Suenabuszu	PN	Suenabuszu
Suhgibildu'a	WN	Suhgibildu'a
Sza'iri	PN	Sza'iri
Szabanasig	PN	Szabanasig
Szadda	PN	Szadda
Szagana	PN	Szagana
Szagubi	PN	Szagubi
Szakkanandul	PN	Szakkanandul
Szakuge	PN	Szakuge
Szalimbeli	PN	Szalimbeli
Szara	DN	Szara
Szara	SN	Szara
Szara'amu	PN	Szara'amu
Szarabansa	PN	Szarabansa
Szarabazige	PN	Szarabazige
Szaragugal	PN	Szaragugal
Szarahegal	PN	Szarahegal
Szarakam	PN	Szarakam
Szarazame	PN	Szarazame
Szarrumbani	PN	Szarrumbani
Szarrumili	PN	Szarrumili
Szaszru	SN	Szaszru
Szaszrum	SN	Szaszrum
Szaszszuru	SN	Szaszszuru
Szaszszurum	SN	Szaszszurum
Szatakuzu	PN	Szatakuzu
Szayatmami	PN	Szayatmami
Sze'ila	MN	Sze'ila
Sze'illa	MN	Sze'illa
Szegbar	PN	Szegbar
Szekaragala	MN	Szekaragala
Szeleputum	PN	Szeleputum
Szesagku	MN	Szesagku
Szeszani	PN	Szeszani
Szeszdada	PN	Szeszdada
Szeszkala	PN	Szeszkala
Szeszszesz	PN	Szeszszesz
Szimaszgi	N	Szimaszgi
Szimaszgi	N	Szimaszkian
Szu'abba	PN	Szu'abba
Szu'admu	PN	Szu'admu
Szu'ene	PN	Szu'ene
Szu'enlil	PN	Szu'enlil
Szu'enlila	PN	Szu'enlila
Szu'era	PN	Szu'era
Szu'eszdar	PN	Szu'eszdar
Szu'eszsza	MN	Szu'eszsza
Szu'igidu	N	advance_payment
Szu'ili	PN	Szu'ili
Szu'iliszu	PN	Szu'iliszu
Szu'iszkur	PN	Szu'iszkur
Szu'u'a	PN	Szu'u'a
Szu'utu	PN	Szu'utu
Szubaxgal	PN	Szubaxgal
Szuea	PN	Szuea
Szugargal	MN	Szugargal
Szugarra	MN	Szugarra
Szukabta	PN	Szukabta
Szukubum	PN	Szukubum
Szuledudu	PN	Szuledudu
Szulgi'abi	PN	Szulgi'abi
Szulgi'irimu	PN	Szulgi'irimu
Szulgidangada	PN	Szulgidangada
Szulgir	RN	Szulgir
Szulgirayamu	PN	Szulgirayamu
Szulgirdangada	PN	Szulgirdangada
Szulgirili	PN	Szulgirili
Szulgirmiszar	PN	Szulgirmiszar
Szulgirmudah	PN	Szulgirmudah
Szulgirzimu	PN	Szulgirzimu
Szulgisi'imtum	PN	Szulgisi'imtum
Szulgiszamszi	PN	Szulgiszamszi
Szumam	PN	Szumam
Szumama	PN	Szumama
Szumamitum	PN	Szumamitum
Szumana	PN	Szumana
Szuna	FN	Szuna
Szunirruku	PN	Szunirruku
Szunukusz	PN	Szunukusz
Szunumun	MN	Szunumun
Szuruppak	SN	Szuruppak
Szusuen	RN	Szusuen
Szuszin	SN	Szuszin
Szuszulgir	PN	Szuszulgir
Szuszumudar	PN	Szuszumudar
Szuzu	PN	Szuzu
Tabbeli	PN	Tabbeli
Tahiszatal	PN	Tahiszatal
Titi	PN	Titi
Tulta	PN	Tulta
Tultapada	PN	Tultapada
Tummal	SN	Tummal
Tur	FN	Tur
Turamili	PN	Turamili
Turtura	PN	Turtura
UDISZ	PN	UDISZ
Ubar	PN	Ubar
Ubigu	MN	Ubigu
Uburli	PN	Uburli
Uda	PN	Uda
Udaya	PN	Udaya
Udumulli	FN	Udumulli
Uduninarali	FN	Uduninarali
Uduninarali	PN	Uduninarali
Ugudu	PN	Ugudu
Ugulageszda	PN	Ugulageszda
Ukunuti	FN	Ukunuti
Ulmaszitum	DN	Ulmaszitum
Umani	PN	Umani
Umma	SN	Umma
Unapszen	PN	Unapszen
Unu	SN	Unu
Unug	SN	Unug
Upi	SN	Upi
Uraba	PN	Uraba
Urababa	PN	Urababa
Urabba	PN	Urabba
Urabbasaga	PN	Urabbasaga
Urabzu	PN	Urabzu
Uramana	PN	Uramana
Uramma	PN	Uramma
Urani	PN	Urani
Urasarluhi	PN	Urasarluhi
Urasznan	PN	Urasznan
Uraya	PN	Uraya
Urbaba	PN	Urbaba
Urbadtibira	PN	Urbadtibira
Urbagara	PN	Urbagara
Urbaya	PN	Urbaya
Urbil	PN	Urbil
Urbilum	SN	Urbilum
Urdagi	PN	Urdagi
Urdamu	PN	Urdamu
Urdubla	PN	Urdubla
Urdumuzi	PN	Urdumuzi
Urdumuzida	PN	Urdumuzida
Urdun	PN	Urdun
Ure'anna	PN	Ure'anna
Ure'e	PN	Ure'e
Urebabbar	PN	Urebabbar
Uregula	PN	Uregula
Uremah	PN	Uremah
Uremasz	PN	Uremasz
Urenki	PN	Urenki
Urenlila	PN	Urenlila
Urenlilak	PN	Urenlilak
Urenuna	PN	Urenuna
Urgepar	PN	Urgepar
Urgesztinanka	PN	Urgesztinanka
Urgigir	PN	Urgigir
Urgilgamesx	PN	Urgilgamesx
Urgu	PN	Urgu
Urgu'edina	PN	Urgu'edina
Urgug	PN	Urgug
Urha'ia	PN	Urha'ia
Urhendursag	PN	Urhendursag
Urigalim	PN	Urigalim
Urigizibarra	PN	Urigizibarra
Urim	SN	Urim
Uristaran	PN	Uristaran
Urisza	PN	Urisza
Uriszkur	PN	Uriszkur
Urisztaran	PN	Urisztaran
Urkigulame	PN	Urkigulame
Urkun	PN	Urkun
Urkununa	PN	Urkununa
Urlamma	PN	Urlamma
Urlamsag	PN	Urlamsag
Urli	GN	Urli
Urli	PN	Urli
Urlisi	PN	Urlisi
Urlisina	PN	Urlisina
Urlugal	PN	Urlugal
Urlugalbanda	PN	Urlugalbanda
Urmah	N	Urmah
Urmama	PN	Urmama
Urmami	PN	Urmami
Urmeme	PN	Urmeme
Urmes	PN	Urmes
Urnamma	RN	Urnamma
Urnansze	PN	Urnansze
Urnanszeka	PN	Urnanszeka
Urnerah	PN	Urnerah
Urnigar	PN	Urnigar
Urningeszzida	PN	Urningeszzida
Urninlila	PN	Urninlila
Urninmug	PN	Urninmug
Urninmuga	PN	Urninmuga
Urnintu	PN	Urnintu
Urnisaba	PN	Urnisaba
Urnumuszda	PN	Urnumuszda
Urnungal	PN	Urnungal
Urpagara	PN	Urpagara
Urru	PN	Urru
Ursaga	PN	Ursaga
Ursagamu	PN	Ursagamu
Ursagku	PN	Ursagku
Ursilaluh	PN	Ursilaluh
Ursu'anak	PN	Ursu'anak
Ursudda	PN	Ursudda
Ursuddame	PN	Ursuddame
Ursuen	PN	Ursuen
Urszakidu	PN	Urszakidu
Urszakkan	PN	Urszakkan
Urszara	PN	Urszara
Urszenamnuntu	PN	Urszenamnuntu
Urszulgir	PN	Urszulgir
Urszulpa'e	PN	Urszulpa'e
Urszuszbaba	PN	Urszuszbaba
Urszuzi'andul	PN	Urszuzi'andul
Urtulmah	PN	Urtulmah
Urtur	PN	Urtur
Uru	PN	Uru
Urum	SN	Urum
Urutu	PN	Urutu
Urzikuma	PN	Urzikuma
Urzu	PN	Urzu
Usur	GN	Usur
Uszgida	FN	Uszgida
Uszkalimmu	DN	Uszkalimmu
Uszmu	PN	Uszmu
Utamiszaram	PN	Utamiszaram
Utu	DN	Utu
UtuGIRgal	PN	UtuGIRgal
Utubani	PN	Utubani
Utubara	PN	Utubara
Utuhesa	PN	Utuhesa
Utumu	PN	Utumu
Uwarida	WN	Uwarida
Watarum	PN	Watarum
Zabszali	SN	Zabszali
Zage	PN	Zage
Zamu	PN	Zamu
Zarig	PN	Zarig
Zayanum	PN	Zayanum
Zinana	PN	Zinana
Zu'al	PN	Zu'al
Zubaga	PN	Zubaga
Zusi	MN	Zusi
Zuzu	PN	Zuzu
Zuzu'a	PN	Zuzu'a
_(_)	NU	_
_(ban)	N	unit
_(barig)	N	unit
_(bur)	N	unit
_(esze)	N	unit
_(iku)	N	unit
a'abak	N	stone_type
a'aga	N	news
ab	N	cow
abba	N	elder
abba	N	father
abba'iri	N	city_elder
abmah	N	mature_cow
adKID	N	basket_weaver
adda	N	father
aga	N	tiara
aga'us	N	soldier
aga'usgal	N	head_soldier
agiba	N	midnight
al	N	hoe
al	N	hoeing
alan	N	statue
allaharu	N	unknown
am	N	bull
ama	N	mother
amagan	N	breeding_female_animal
amar	N	calf
amaru	N	flood
anigin	N	reservoir
anna	N	tin
ansze	N	donkey
anubda	N	quarter
anzam	N	drinking_vessel
apin	N	plow
apinla	N	tenancy
apinla	N	tiller
ara	N	part_of_boat
ara	N	times
arad	N	slave
aria	N	disease
armatum	N	door
aslum	N	sheep_type
asz	NU	one
aszag	N	field
aszgab	N	leatherworker
aszgabgal	N	head_leatherworker
aszgar	N	female_kid
atua	N	lustration
aziga	N	rising_water
azlag	N	fuller
azur	N	type_of_sheep
ba	N	animal
baba	N	porridge
bad	N	wall
badgal	N	great_wall
bahar	N	potter
bala	N	tax
bala	N	turn
ban	N	measuring_container
banda	N	child
bandudu	N	seeding_basket
banszur	N	table
bar	N	outside
baragsiga	N	shrine
bargal	N	fleeced_sheep
bariga	N	unit
bisag	N	basket
bisagdubak	N	archivist
bisagdubak	N	filing_basket
bitum	N	administrative_term
bulug	N	needle
bunig	N	trough
dabatum	N	textile_type
dabin	N	semolina
dal	N	crossbar
dam	N	spouse
damgar	N	merchant
dehi	N	stanchion
did	N	lawsuit
dida	N	sweet_wort
dikud	N	judge
diri	N	intercalary_month
dirig	N	excess
du	N	ur
dub	N	tablet
dubdub	N	flour_designation
dublamah	TN	magnificent_tower
dubsar	N	scribe
dug	N	pot
duggan	N	leather_bag
duh	N	bran
dukug	N	locus
dul	N	shade
dumu	N	child
dumu	N	son
dumugi	N	citizen
dumugugur	N	worker
dumumunus	N	daughter
dus	N	path
dusu	N	donkey
e'esir	N	house_of_bitumen
e'udu	N	sheephouse
e'uszbar	N	textile_workshop
e'uzga	N	building_type
eban	N	pair
eduru	N	village
eg	N	levee
ega	N	dairy
egal	N	palace
egesz	N	workshop
egir	N	back
egizid	N	priestess
egud	N	ox_barn
ekinkin	N	mill
ekiszibak	N	storeroom
elungak	N	brewery
ememah	N	mature_donkey
emuhaldim	N	kitchen
en	N	priest
engar	N	farmer
engargusuhub	N	farmer
enkud	N	tax_collector
ennug	N	guard
ennug	N	prison
ennug	N	watch
ensik	N	ruler
eren	N	cedar
erin	N	people
eringaba	N	unknown
esir	N	bitumen
esir	N	shoe
esz	N	shrine
esza	N	flour
eszesz	N	festival
esztub	N	carp
etur	N	stall
ezem	N	festival
ga	N	house
ga	N	milk
ga	N	suckling
ga'ar	N	cheese
gaba	N	frontier
gabari	N	copy
gabil	N	basket
gabra	N	rider
gabus	N	shepherd_helper
gada	N	flax
gag	N	peg
gagsala	N	hook
gagsisa	N	arrow
gagsum	N	arrow_type
gakkul	N	mash_tub
gana	N	field
ganun	N	storehouse
garig	N	comb
gasze'a	N	sour_milk
gaz	N	type_of_garlic
gazi	N	condiment
geme	N	female_worker
gesz	N	barrage
gesz	N	tree
geszdu	N	breeder
geszdu	N	breeding_stock
geszi	N	sesame
geszkesz	N	dam
geszkigti	N	workshop
gesznimbar	N	date_palm
gesznimbar	N	palm
gesztin	N	vine
gesztug	N	wisdom
geszur	N	harrow
gi	N	reed
gi	N	thicket
giba'a	N	midnight
gid	N	length
gidua	N	fence
gidua	N	reed_fence
gig	N	measuring_tool
gig	N	resin_type
gig	N	unit
gigesz	N	reed_thicket
gigir	N	chariot
gimusz	N	pole
gina	N	dues
gipar	N	cloister
giranum	N	wailing
giri	N	foot
giridab	N	driver
girlam	N	basket_type
girsiga	N	attendant
gizi	N	reed
gu	N	bank
gu	N	cord
gu	N	neck
gud	N	ox
gudapin	N	plow_ox
gude'usa	N	lowest_quality
gudgesz	N	draught_ox
gudug	N	priest
gugala	N	chickpea
gun	N	rent
gun	N	tribute
gunigin	N	bale
gur	N	measuring_vessel
gur	N	unit
gurdub	N	basket
guru	N	grain_heap
guru	N	store
gurum	N	inspection
gurusz	N	male
guza	N	chair
guzala	N	throne_bearer
habuda	N	hoe
hal	N	basket
haltur	N	basket_type
hankaze	N	reed_product_type
haran	N	plant
haszhur	N	apple
hedab	N	worker
i'udu	N	sheep_fat
ib	N	middle
iba	N	oil_ration
ibiza	N	financial_loss
id	N	river
idgurum	N	ladle
idu	N	doorkeeper
idub	N	granary
ig	N	door
igara	N	dairy
igesz	N	oil
igi	N	eye
igi4(disz)	NU	one
igi6(disz)	NU	one
igidua	N	priestess
igu	N	flax_oil
ikud	N	fish_oil
im	N	clay
imba	N	deficit
imbabbar	N	gypsum
imdua	N	wall
imgaga	N	emmer
imkusig	N	orpiment
ina	N	unknown
inim	N	matter
inim	N	word
innu	N	straw
inun	N	ghee
iri	N	city
isz	N	flour_type
iszah	N	lard
iszib	N	priest
iti	N	month
itud	N	worker_category
izigu	N	loss
ka	N	mouth
ka'usa	N	profession_type
kabkul	N	container
kabkul	N	water_installation
kabkul	N	water_installationr
kabur	N	profession
kadar	N	unknown
kag	N	mouth
kagir	N	reed_mat
kaguruk	N	granary_supervisor
kaguruk	N	supervisor
kakaku	N	profession
kan	N	gate
kar	N	harbor
karkimura	N	habour_of_depository
kas	N	runner
kaskal	N	journey
kaskal	N	travel_basket
kasz	N	beer
kaszdea	N	banquet
kataba	N	double_mouth
ki	N	place
ki'anag	N	place_of_libations
ki'engi	GN	ki'engi
ki'uri	GN	ki'uri
kid	N	mat
kig	N	work
kiggia	N	messenger
kikken	N	miller
kikken	N	millstone
kila	N	size
kila	N	weight
kir	N	female_lamb
kiri	N	orchard
kisur	N	threshing_floor
kiszib	N	seal
kiszib	N	sealed_tablet
kiszibba	N	sealed_tablets
kiszig	N	acacia
ku	N	unknown
kud	N	fish
kuda	PN	kuda
kudu	N	metal_vessel_type
kug	N	silver
kugan	N	metal_type
kugbabbar	N	silver
kugdim	N	smith
kugsig	N	gold
kunga	N	equid_type
kunzida	N	weir
kur	N	east
kur	N	mountain
kuruszda	N	animal_fattener
kusz	N	cattle_manager
kusz	N	leather
kusze	N	cooked_fish
la'u	N	arrears
lagab	N	stump
lal	N	syrup
limmu	NU	four
lu	N	person
lu'inimak	N	witness
lugal	N	king
lukur	N	priestess
lulum	N	sheep_designation
lungak	N	brewer
ma	N	ship
mada	N	land
magur	N	barge
magurmah	N	great_barge
mah	N	great
malah	N	sailor
mana	N	unit
mansim	N	sieve
manu	N	wood
manu	N	wood_type
mar	N	shovel
mar	N	wagon
marim	N	clay_shovel
marsa	N	military_depot
marsa	N	shipyard
marza	N	rites
masz	N	goat
masz	N	interest
maszda	N	gazelle
maszda	N	stone
maszdamunus	N	female_gazelle
maszdanita	N	male_gazelle
maszdarea	N	payment
maszgal	N	billy_goat
maszkim	N	administrator
masznita	N	male_goat
mer	N	north
min	NU	two
mu	N	name
mu	N	year
mug	N	inferior_wool
muhaldim	N	cook
mukur	N	delivery
mun	N	salt
munsub	N	shepherd
munu	N	malt
munus	N	woman
murgu	N	fodder
murgu	N	tree_type
muru	N	mat
murub	N	middle
muszendu	N	bird_catcher
na	N	stone_weight
naga	N	potash
nagada	N	herdsman
nagar	N	carpenter
nakabtum	N	stockyard
namah	N	magnificent_stone
namszatam	N	administration
namtil	N	life
narua	N	stele
naruamah	N	magnificent_stele
nemur	N	ashes
nesag	N	first_fruit_offering
ni	N	self
nig	N	unknown
nigGA	N	property
nigSZID	N	account
nigara	N	groats
nigba	N	gift
nigdab	N	requisitions
nigena	N	property_type
nigezema	N	festival_material
niggala	N	possessions
nigin	N	bundle
nigki	N	fish
nigkizah	N	cult_offering
niglam	N	ceremonial_garment
nigluh	N	basin
nigmussa	N	bride
nigmussa	N	gift
nigsaga	N	goodness
nigsam	N	price
nigszukur	N	ration
nigtaga	N	sacrifice
nin	N	lady
ninda	N	bread
nindan	N	pole
nita	N	male
nu	N	night_bird
nu'eszak	N	priest
nubanda	N	overseer
nubandagu	N	ox_overseer
nudab	N	worker
nukirik	N	gardener
numun	N	seed
nun	N	prince
pa	N	branch
pakud	N	stave
pesz	N	fig
ragaba	N	rider
rubatum	N	princess
sa	N	bundle
sabar	N	net
sadug	N	offerings
sadurra	N	bottom
sag	N	front_side
sag	N	head
sagDUN	N	land_recorder
sagga	N	temple_administrator
saggal	N	food
sagi	N	cup_bearer
sagkesz	N	state
sagkul	N	bolt
sagnigGArak	N	available_assets
sahar	N	earth
sar	N	unit
sig	N	class_of_worker
siki	N	wool
siki'ud	N	goat_wool
sikigi	N	wool_type
sikikurra	N	type_of_wool
sila	N	lamb
simtum	N	measuring_container
simug	N	smith
sipa	N	shepherd
siszkur	N	offering
situm	N	balance
su	N	bird_type
su	N	body
suGAN	N	metallurgical_material
suhub	N	boots
suhur	N	carp
sukkal	N	secretary
sullim	N	spice_type
susu	N	reed_type
szabra	N	chief_administrator
szag	N	heart
szag	N	inner_body
szaggal	N	food
szagra	N	lining
szagsahar	N	earth_worker
szagud	N	ox_driver
szah	N	pig
szahnita	N	male_pig
szakkan	N	unknown
szakkanak	N	general
szakkanak	N	governor
szandana	N	gardener
szandanak	N	gardenner
szarrabdu	N	administrator
sze	N	barley
sze	N	unit
szeba	N	ration
szeg	N	brick
szegbar	N	animal_type
szegeszi	N	sesame_seed
szegin	N	paint
szeli	N	aromatics
szengamebur	N	metal_bowl_type
szenumun	N	seed
szergu	N	string
szerim	NU	part_of_loom
szerrum	N	mat
szesz	N	brother
szim	N	beer_malt
szimaszgi	N	sheep_designation
szimaszigi	N	sheep_designation
szimaszki	N	sheep_designation
szu	N	hand
szu'i	N	barber
szudu'a	N	guarantee
szugan	N	pot_type
szugid	N	animal_designation
szukud	N	fisherman
szukur	N	prebend_land
szukur	N	ration
szuluh	N	ritual_cleansing
szum	N	garlic
szunigin	N	total
szunir	N	emblem
szusar	N	string
szuszuma	N	consignment
ta	N	unknown
tibala	N	portent
tir	N	forest
tir	N	forester
tu	N	soup
tug	N	textile
tugba	N	textile_distribution
tugba	N	textile_ration
tuggur	N	plow
tugmah	N	ceremonial_garment
tukul	N	weapon
tukulgal	N	big_weapon_carrier
tukumbi	CNJ	if
tul	N	ditch
ud	N	day
uda	N	day
udtena	N	evening
udu	N	sheep
udugi	N	native_sheep
uduh	N	days_off
udunita	N	ram
ug	N	people
uggaga	N	porter
ugu	N	capital
ugu	N	top
ugula	N	overseer
ummud	N	waterskin
ur	N	roof
ur	N	yoked_team
urra	N	loan
urud	N	copper
urzir	N	tree_type
usakar	N	crescent_moon
usuh	N	tree
uszbar	N	garment_type
uszbar	N	weaver
uszub	N	brick_mold
utul	N	tureen
utusza	N	holiday
uzu	N	body
uzud	N	goat
za	N	unknown
zabar	N	bronze
zabar	N	measuring_vessel
zabardab	N	official
zadim	N	stone_cutter
zagmuk	N	new_year
zahda	N	piglet
zar	N	sheaf
zena	N	midrib
zid	N	flour
zidIL	N	flour_type
zidgu	N	flour_type
ziga	N	expenditure
zir	N	slip
ziz	N	emmer
zulum	N	date
ag	V	measure
ak	V	present
dab	V	seize
de	V	bring
dim	V	create
du	V	build
du	V	caulk
du	V	hold
dug	V	speak
gal	V	be
gar	V	claim
gar	V	place
gen	V	go
gi	V	return
gid	V	survey
gin	V	comfirm
gu	V	eat
gub	V	pledge
gur	V	return
hug	V	hire
hulu	V	destroy
hun	V	hire
kur	V	enter
la	V	weigh
me	V	be
mu	V	unknown
pad	V	find
pad	V	name
ru	V	dedicate
sa	V	pay_for
sa	V	sell
sig	V	harness
szesz	V	anoint
szum	V	give
taka	V	abandon
tar	V	ask
teg	V	accept
til	V	live
tuku	V	acquire
usz	V	die
zal	V	pass
zig	V	expend
zu	V	know
