
*****NOUN DICT*****

1(disz) 	 NU 	 one
udunita 	 N 	 ram
sila 	 N 	 lamb
azur 	 N 	 type_of_sheep
ki 	 N 	 place
Uru 	 PN 	 Uru
szag 	 N 	 heart
bala 	 N 	 tax
kiszib 	 N 	 seal
Arad 	 PN 	 Arad
iti 	 N 	 month
Szesagku 	 MN 	 1
mu 	 N 	 year
Kimasz 	 SN 	 1
Aradmu 	 PN 	 Aradmu
dubsar 	 N 	 scribe
dumu 	 N 	 child
Urnigar 	 PN 	 Urnigar
kusz 	 N 	 cattle_manager
udu 	 N 	 sheep
maszgal 	 N 	 billy_goat
ud 	 N 	 day
1(u) 	 NU 	 ten
1(disz 	 NU 	 t)
Tummal 	 SN 	 1
Endingirmu 	 PN 	 Endingirmu
Szulgi'irimu 	 PN 	 Szulgi'irimu
szu 	 N 	 hand
Akiti 	 MN 	 1
en 	 N 	 priest
Nanna 	 DN 	 1
1/3(disz) 	 NU 	 one
gig 	 N 	 unit
2(u) 	 NU 	 ten
sze 	 N 	 unit
3(disz) 	 NU 	 one
igi6(disz) 	 NU 	 one
Urbagara 	 PN 	 Urbagara
1(ban) 	 N 	 unit
inun 	 N 	 ghee
6(disz) 	 NU 	 one
ga 	 N 	 milk
gazi 	 N 	 condiment
Urmes 	 PN 	 Urmes
Urdumuzi 	 PN 	 Urdumuzi
Szugargal 	 MN 	 1
Annahilibi 	 PN 	 Annahilibi
Lukala 	 PN 	 Lukala
Pa'u'e 	 MN 	 1
Enunugal 	 PN 	 Enunugal
Inanna 	 DN 	 1
Ure'e 	 PN 	 Ure'e
1(gesz'u) 	 NU 	 six_hundred
sa 	 N 	 bundle
pakud 	 N 	 stave
gunigin 	 N 	 bale
4(disz) 	 NU 	 one
dal 	 N 	 crossbar
5(gesz) 	 NU 	 sixty
manu 	 N 	 wood_type
2(disz) 	 NU 	 one
nigba 	 N 	 gift
lugal 	 N 	 king
Sigtelani 	 PN 	 Sigtelani
giri 	 N 	 foot
Szumama 	 PN 	 Szumama
lu 	 N 	 person
kiggia 	 N 	 messenger
Luturtur 	 PN 	 Luturtur
maszkim 	 N 	 administrator
3(u) 	 NU 	 ten
Urninlila 	 PN 	 Urninlila
sukkal 	 N 	 secretary
Ludingira 	 PN 	 Ludingira
kaguruk 	 N 	 granary_supervisor
Ursilaluh 	 PN 	 Ursilaluh
ensik 	 N 	 ruler
Amarsuen 	 RN 	 1
Szulgir 	 RN 	 1
nita 	 N 	 male
Urim 	 SN 	 1
anubda 	 N 	 quarter
limmu 	 NU 	 four
Urlisi 	 PN 	 Urlisi
Umma 	 SN 	 1
arad 	 N 	 slave
la'u 	 N 	 arrears
Iszsu 	 SN 	 1
Lusa'izu 	 PN 	 Lusa'izu
Dal 	 MN 	 1
bad 	 N 	 wall
Lugalezem 	 PN 	 Lugalezem
Urkun 	 PN 	 Urkun
did 	 N 	 lawsuit
Geme'igalim 	 PN 	 Geme'igalim
Nammah 	 PN 	 Nammah
Sigara 	 PN 	 Sigara
Martu 	 EN 	 1
Lunigin 	 PN 	 Lunigin
inim 	 N 	 word
geme 	 N 	 female_worker
ni 	 N 	 self
ibiza 	 N 	 financial_loss
egal 	 N 	 palace
Gude'a 	 PN 	 Gude'a
abba'iri 	 N 	 city_elder
Lugirsu 	 PN 	 Lugirsu
ugula 	 N 	 overseer
kas 	 N 	 runner
mu 	 N 	 name
inim 	 N 	 matter
Lugugal 	 PN 	 Lugugal
Lubaba 	 PN 	 Lubaba
Erinda 	 PN 	 Erinda
Luszara 	 PN 	 Luszara
Lu'ebgal 	 PN 	 Lu'ebgal
Uristaran 	 PN 	 Uristaran
dikud 	 N 	 judge
szakkanak 	 N 	 governor
Urlamma 	 PN 	 Urlamma
marza 	 N 	 rites
1(gesz) 	 NU 	 sixty
tug 	 N 	 textile
niglam 	 N 	 ceremonial_garment
2/3(disz) 	 NU 	 one
guza 	 N 	 chair
1/2(disz) 	 NU 	 one
5(disz) 	 NU 	 one
sag 	 N 	 front_side
uszbar 	 N 	 garment_type
5/6(disz) 	 NU 	 one
gada 	 N 	 flax
9(disz) 	 NU 	 one
3(gesz) 	 NU 	 sixty
szerim 	 NU 	 part_of_loom
szunigin 	 N 	 total
4(u) 	 NU 	 ten
tuggur 	 N 	 plow
Lu'igisasa 	 PN 	 Lu'igisasa
Nabasa 	 PN 	 Nabasa
dirig 	 N 	 excess
Ugudu 	 PN 	 Ugudu
sar 	 N 	 unit
sahar 	 N 	 earth
kabkul 	 N 	 water_installation
A'uda 	 FN 	 1
Uduninarali 	 FN 	 1
2(gesz) 	 NU 	 sixty
5(u) 	 NU 	 ten
Kibad 	 FN 	 1
Usur 	 GN 	 1
tir 	 N 	 forest
kig 	 N 	 work
id 	 N 	 river
Ninhursag 	 DN 	 1
szukur 	 N 	 ration
engar 	 N 	 farmer
nubandagu 	 N 	 ox_overseer
szagsahar 	 N 	 earth_worker
eg 	 N 	 levee
sadurra 	 N 	 bottom
aszag 	 N 	 field
Uwarida 	 WN 	 1
Iszibene 	 FN 	 1
8(gesz2) 	 NU 	 sixty
Dada 	 PN 	 Dada
Anszan 	 GN 	 1
Nani 	 PN 	 Nani
5(asz) 	 NU 	 one
sze 	 N 	 barley
gur 	 N 	 unit
urra 	 N 	 loan
Lugalmelam 	 PN 	 Lugalmelam
Urmama 	 PN 	 Urmama
7(disz) 	 NU 	 one
gurusz 	 N 	 male
Gusuhub 	 FN 	 1
haran 	 N 	 plant
kabkul 	 N 	 water_installationr
Urdamu 	 PN 	 Urdamu
Iniminanna 	 PN 	 Iniminanna
Lugalitida 	 PN 	 Lugalitida
ziz 	 N 	 emmer
Urdumuzida 	 PN 	 Urdumuzida
1(bariga) 	 N 	 unit
Dumuzi 	 MN 	 1
Szusuen 	 RN 	 1
narua 	 N 	 stele
mah 	 N 	 great
Enlil 	 DN 	 1
Ninlil 	 DN 	 1
am 	 N 	 bull
gud 	 N 	 ox
amar 	 N 	 calf
Abbasaga 	 PN 	 Abbasaga
Szu'eszsza 	 MN 	 1
Urbilum 	 SN 	 1
siszkur 	 N 	 offering
Hibaritum 	 SN 	 1
Minesz 	 MN 	 1
ki'engi 	 GN 	 1
ki'uri 	 GN 	 1
kugbabbar 	 N 	 silver
Kilula 	 PN 	 Kilula
igi4(disz) 	 NU 	 one
kug 	 N 	 silver
Manba 	 PN 	 Manba
Nigarkidu 	 PN 	 Nigarkidu
Akala 	 PN 	 Akala
masz 	 N 	 interest
8(disz) 	 NU 	 one
Enmahgalana 	 PN 	 Enmahgalana
6(asz) 	 NU 	 one
4(bariga) 	 N 	 unit
mukur 	 N 	 delivery
Urnansze 	 PN 	 Urnansze
Szuledudu 	 PN 	 Szuledudu
Gurabimumu 	 MN 	 1
4(ban) 	 N 	 unit
2(bariga) 	 N 	 unit
gudug 	 N 	 priest
gabari 	 N 	 copy
kiszibba 	 N 	 sealed_tablets
Ursuen 	 PN 	 Ursuen
Nesag 	 MN 	 1
Szara 	 DN 	 1
gun 	 N 	 rent
namah 	 N 	 magnificent_stone
Inta'e'a 	 PN 	 Inta'e'a
Ezemszulgir 	 MN 	 1
Unug 	 SN 	 1
Lugalazida 	 PN 	 Lugalazida
Szeszkala 	 PN 	 Szeszkala
Siga 	 MN 	 1
Aradam 	 PN 	 Aradam
lu'inimak 	 N 	 witness
Apindu'a 	 MN 	 1
Simanum 	 SN 	 1
Lugalengardu 	 PN 	 Lugalengardu
dug 	 N 	 pot
dida 	 N 	 sweet_wort
kasz 	 N 	 beer
ninda 	 N 	 bread
naga 	 N 	 potash
kud 	 N 	 fish
szum 	 N 	 garlic
Lamamu 	 PN 	 Lamamu
Utumu 	 PN 	 Utumu
E'iti6 	 MN 	 1
Huh 	 SN 	 1
habuda 	 N 	 hoe
kila 	 N 	 weight
mana 	 N 	 unit
Dadaga 	 PN 	 Dadaga
Szunumun 	 MN 	 1
igesz 	 N 	 oil
idgurum 	 N 	 ladle
Ahu'aga 	 PN 	 Ahu'aga
damgar 	 N 	 merchant
Sagazak 	 SN 	 1
Balu 	 N 	 1
ka 	 N 	 mouth
Kaya 	 SN 	 1
Nibru 	 SN 	 1
szah 	 N 	 pig
amagan 	 N 	 breeding_female_animal
szahnita 	 N 	 male_pig
zahda 	 N 	 piglet
Szukabta 	 PN 	 Szukabta
Basaga 	 PN 	 Basaga
nigSZID 	 N 	 account
nigGA 	 N 	 property
Szeleputum 	 PN 	 Szeleputum
dumumunus 	 N 	 daughter
Nuhidingir 	 PN 	 Nuhidingir
sipa 	 N 	 shepherd
Bayaga 	 PN 	 Bayaga
kuruszda 	 N 	 animal_fattener
mada 	 N 	 land
Zabszali 	 SN 	 1
zidgu 	 N 	 flour_type
alan 	 N 	 statue
Neduhuli 	 SN 	 1
Ubar 	 PN 	 Ubar
Baba 	 PN 	 Baba
i'udu 	 N 	 sheep_fat
tukulgal 	 N 	 big_weapon_carrier
aga'us 	 N 	 soldier
Bazi 	 PN 	 Bazi
Puzureszdar 	 PN 	 Puzureszdar
aziga 	 N 	 rising_water
Kala 	 PN 	 Kala
gurdub 	 N 	 basket
tu 	 N 	 soup
Puzuriszkur 	 PN 	 Puzuriszkur
Der 	 SN 	 1
erin 	 N 	 people
Huhnuri 	 SN 	 1
8(asz) 	 NU 	 one
masz 	 N 	 goat
igi 	 N 	 eye
Ugulageszda 	 PN 	 Ugulageszda
ezem 	 N 	 festival
nesag 	 N 	 first_fruit_offering
Madara'abzu 	 ON 	 1
Enki 	 DN 	 1
Lugalsaga 	 PN 	 Lugalsaga
Nalu 	 PN 	 Nalu
1(asz) 	 NU 	 one
3(bariga) 	 N 	 unit
Urutu 	 PN 	 Urutu
Gaduszana'um 	 PN 	 Gaduszana'um
Urgilgamesx 	 PN 	 Urgilgamesx
Urlamsag 	 PN 	 Urlamsag
bahar 	 N 	 potter
Nigurum 	 PN 	 Nigurum
aria 	 N 	 disease
Lu'utu 	 PN 	 Lu'utu
Szuzu 	 PN 	 Szuzu
Girini 	 PN 	 Girini
adKID 	 N 	 basket_weaver
Mepa'e 	 PN 	 Mepa'e
kakaku 	 N 	 profession
aszgab 	 N 	 leatherworker
szeba 	 N 	 ration
zagmuk 	 N 	 new_year
Isztaran 	 DN 	 1
Nigdu 	 PN 	 Nigdu
2(asz) 	 NU 	 one
3(ban) 	 N 	 unit
Urlisina 	 PN 	 Urlisina
Uregula 	 PN 	 Uregula
3(asz) 	 NU 	 one
bisagdubak 	 N 	 filing_basket
gurum 	 N 	 inspection
szukud 	 N 	 fisherman
muszendu 	 N 	 bird_catcher
ara 	 N 	 times
Insasa 	 PN 	 Insasa
Igidar 	 PN 	 Igidar
Simurrum 	 SN 	 1
Lulubu 	 SN 	 1
Girsu 	 SN 	 1
_(_) 	 NU 	 _
Isalla 	 SN 	 1
Abbagina 	 PN 	 Abbagina
Aszi'an 	 PN 	 Aszi'an
Lugalemahe 	 PN 	 Lugalemahe
Lisi 	 MN 	 1
Lugalkugani 	 PN 	 Lugalkugani
Szakkanandul 	 PN 	 Szakkanandul
Angugumu 	 PN 	 Angugumu
Urabba 	 PN 	 Urabba
Hala 	 PN 	 Hala
Alulu 	 PN 	 Alulu
Urasznan 	 PN 	 Urasznan
Urabbasaga 	 PN 	 Urabbasaga
Urenki 	 PN 	 Urenki
Uremah 	 PN 	 Uremah
Lugalmagure 	 PN 	 Lugalmagure
Ayalni 	 PN 	 Ayalni
Lugalgigire 	 PN 	 Lugalgigire
4(asz) 	 NU 	 one
Szadda 	 PN 	 Szadda
Lugalkisal 	 PN 	 Lugalkisal
Dadaya 	 PN 	 Dadaya
Igigirnimu 	 PN 	 Igigirnimu
Lugalbad 	 PN 	 Lugalbad
Inimszara 	 PN 	 Inimszara
5(ban) 	 N 	 unit
emuhaldim 	 N 	 kitchen
Szaszszurum 	 SN 	 1
Lugalsine'e 	 PN 	 Lugalsine'e
Urgigir 	 PN 	 Urgigir
iszah 	 N 	 lard
marsa 	 N 	 shipyard
Lugalniglagare 	 PN 	 Lugalniglagare
Nasilim 	 PN 	 Nasilim
Umani 	 PN 	 Umani
Namlugalidu 	 PN 	 Namlugalidu
magurmah 	 N 	 great_barge
7(gesz) 	 NU 	 sixty
bisag 	 N 	 basket
gid 	 N 	 length
kid 	 N 	 mat
haltur 	 N 	 basket_type
bandudu 	 N 	 seeding_basket
gakkul 	 N 	 mash_tub
abba 	 N 	 father
ansze 	 N 	 donkey
hankaze 	 N 	 reed_product_type
simtum 	 N 	 measuring_container
gur 	 N 	 measuring_vessel
nigara 	 N 	 groats
ban 	 N 	 measuring_container
haszhur 	 N 	 apple
innu 	 N 	 straw
zid 	 N 	 flour
gig 	 N 	 measuring_tool
Ningeszkimzi 	 PN 	 Ningeszkimzi
uduh 	 N 	 days_off
zar 	 N 	 sheaf
ab 	 N 	 cow
Marhaszi 	 SN 	 1
Ahuni 	 PN 	 Ahuni
Enlila 	 PN 	 Enlila
nigdab 	 N 	 requisitions
Ayakala 	 PN 	 Ayakala
Apisal 	 FN 	 1
Muszbi'anna 	 FN 	 1
bar 	 N 	 outside
Puzurdagan 	 SN 	 1
Amma 	 PN 	 Amma
nagada 	 N 	 herdsman
szimaszgi 	 N 	 sheep_designation
Ezemanna 	 MN 	 1
sikigi 	 N 	 wool_type
Lugalandul 	 PN 	 Lugalandul
a'aga 	 N 	 news
Szaszszuru 	 SN 	 1
Tahiszatal 	 PN 	 Tahiszatal
Ezemninazu 	 MN 	 1
Szaszru 	 SN 	 1
bitum 	 N 	 administrative_term
Du'udu 	 PN 	 Du'udu
igidua 	 N 	 priestess
Sigiszubbagar 	 MN 	 1
Ibbisuen 	 RN 	 1
duh 	 N 	 bran
2(ban) 	 N 	 unit
gabil 	 N 	 basket
nigki 	 N 	 fish
9(asz) 	 NU 	 one
sabar 	 N 	 net
kusze 	 N 	 cooked_fish
9(gesz) 	 NU 	 sixty
nigszukur 	 N 	 ration
ekiszibak 	 N 	 storeroom
7(asz) 	 NU 	 one
zabardab 	 N 	 official
Babati 	 PN 	 Babati
nig 	 N 	 unknown
hal 	 N 	 basket
esir 	 N 	 bitumen
Kugani 	 PN 	 Kugani
Urszulgir 	 PN 	 Urszulgir
su 	 N 	 bird_type
apin 	 N 	 plow
mar 	 N 	 shovel
dehi 	 N 	 stanchion
banszur 	 N 	 table
marim 	 N 	 clay_shovel
nu 	 N 	 night_bird
ku 	 N 	 unknown
urud 	 N 	 copper
kan 	 N 	 gate
geszur 	 N 	 harrow
gigesz 	 N 	 reed_thicket
eren 	 N 	 cedar
szim 	 N 	 beer_malt
szakkan 	 N 	 unknown
susu 	 N 	 reed_type
mansim 	 N 	 sieve
maszda 	 N 	 gazelle
anzam 	 N 	 drinking_vessel
al 	 N 	 hoe
gag 	 N 	 peg
kadar 	 N 	 unknown
uszub 	 N 	 brick_mold
szeg 	 N 	 brick
a'abak 	 N 	 stone_type
gagsala 	 N 	 hook
zena 	 N 	 midrib
gesznimbar 	 N 	 date_palm
banda 	 N 	 child
suhur 	 N 	 carp
ig 	 N 	 door
lagab 	 N 	 stump
kusz 	 N 	 leather
Urnerah 	 PN 	 Urnerah
szabra 	 N 	 chief_administrator
Gibilka'isa 	 PN 	 Gibilka'isa
Urhendursag 	 PN 	 Urhendursag
Munugu 	 MN 	 1
Luzabala 	 PN 	 Luzabala
Kalamu 	 PN 	 Kalamu
Badirina 	 PN 	 Badirina
szaggal 	 N 	 food
gaba 	 N 	 frontier
Eridug 	 SN 	 1
nudab 	 N 	 worker
hedab 	 N 	 worker
gu 	 N 	 bank
Niginszedu 	 WN 	 1
Durul 	 WN 	 1
eduru 	 N 	 village
Upi 	 SN 	 1
Urszulpa'e 	 PN 	 Urszulpa'e
im 	 N 	 clay
gesz 	 N 	 tree
Lugina 	 PN 	 Lugina
ememah 	 N 	 mature_donkey
bargal 	 N 	 fleeced_sheep
6(gesz) 	 NU 	 sixty
4(gesz) 	 NU 	 sixty
kaszdea 	 N 	 banquet
Ninkala 	 PN 	 Ninkala
maszdarea 	 N 	 payment
sadug 	 N 	 offerings
nigtaga 	 N 	 sacrifice
abmah 	 N 	 mature_cow
ga 	 N 	 suckling
szegbar 	 N 	 animal_type
Lupada 	 PN 	 Lupada
Lugaldubla 	 PN 	 Lugaldubla
egud 	 N 	 ox_barn
ugu 	 N 	 capital
Kas 	 PN 	 Kas
Urszara 	 PN 	 Urszara
bisagdubak 	 N 	 archivist
Ki'an 	 SN 	 1
Lusuen 	 PN 	 Lusuen
Basa 	 PN 	 Basa
Dagi 	 PN 	 Dagi
Urnisaba 	 PN 	 Urnisaba
Lubanda 	 PN 	 Lubanda
ziga 	 N 	 expenditure
idub 	 N 	 granary
2(bur) 	 N 	 unit
gana 	 N 	 field
4(iku) 	 N 	 unit
1/2(iku) 	 N 	 unit
Lugalkuzu 	 PN 	 Lugalkuzu
Hesa 	 PN 	 Hesa
iszib 	 N 	 priest
1(bur) 	 N 	 unit
1(esze) 	 N 	 unit
5(iku) 	 N 	 unit
Duru 	 FN 	 1
nun 	 N 	 prince
kag 	 N 	 mouth
Nannagugal 	 WN 	 1
2(iku) 	 N 	 unit
Durunannagugal 	 FN 	 1
9(bur) 	 N 	 unit
2(esze) 	 N 	 unit
1(iku) 	 N 	 unit
Muru 	 FN 	 1
egizid 	 N 	 priestess
Kuli 	 PN 	 Kuli
Uda 	 PN 	 Uda
3(bur'u) 	 N 	 unit
Kage 	 PN 	 Kage
Geszgibanda 	 FN 	 1
8(bur) 	 N 	 unit
1/4(iku) 	 N 	 unit
murgu 	 N 	 tree_type
kiri 	 N 	 orchard
Hendursag 	 DN 	 1
4(bur) 	 N 	 unit
1(bur'u) 	 N 	 unit
Katul 	 FN 	 1
Szuna 	 FN 	 1
1(szar) 	 N 	 unit
3(iku) 	 N 	 unit
Dalbana 	 FN 	 1
eringaba 	 N 	 unknown
Urli 	 PN 	 Urli
iri 	 N 	 city
6(bur) 	 N 	 unit
Sallesa 	 FN 	 1
4(bur'u) 	 N 	 unit
Idigna 	 WN 	 1
sagga 	 N 	 temple_administrator
Ebabbar 	 TN 	 1
3(bur) 	 N 	 unit
_(bur) 	 N 	 unit
_(esze) 	 N 	 unit
_(iku) 	 N 	 unit
Luninildama 	 PN 	 Luninildama
Uszgida 	 FN 	 1
niggala 	 N 	 possessions
sagDUN 	 N 	 land_recorder
pa 	 N 	 branch
manu 	 N 	 wood
ekinkin 	 N 	 mill
baba 	 N 	 porridge
E'urbidu 	 PN 	 E'urbidu
Kugninura 	 PN 	 Kugninura
Nasa 	 PN 	 Nasa
Urbaba 	 PN 	 Urbaba
Nannaki'ag 	 N 	 1
aslum 	 N 	 sheep_type
uzud 	 N 	 goat
Bayabalum 	 PN 	 Bayabalum
szugid 	 N 	 animal_designation
Irisagrig 	 SN 	 1
Lugalnimah 	 PN 	 Lugalnimah
Lugalsisa 	 PN 	 Lugalsisa
Nannazi 	 PN 	 Nannazi
Era'ursag 	 PN 	 Era'ursag
nubanda 	 N 	 overseer
Dayagi 	 PN 	 Dayagi
Layamu 	 PN 	 Layamu
Lugalnesage 	 PN 	 Lugalnesage
giridab 	 N 	 driver
kur 	 N 	 mountain
Urru 	 PN 	 Urru
Lugula 	 PN 	 Lugula
Szabanasig 	 PN 	 Szabanasig
Szeszdada 	 PN 	 Szeszdada
Utu 	 DN 	 1
Uriszkur 	 PN 	 Uriszkur
Nannahegal 	 PN 	 Nannahegal
szandanak 	 N 	 gardenner
Urkununa 	 PN 	 Urkununa
azlag 	 N 	 fuller
Inxx 	 PN 	 Inxx
ragaba 	 N 	 rider
Urisza 	 PN 	 Urisza
Luduga 	 PN 	 Luduga
gi 	 N 	 reed
3(disz 	 NU 	 t)
Menkar 	 FN 	 1
Urnamma 	 RN 	 1
Adumu 	 PN 	 Adumu
Ukunuti 	 FN 	 1
Gine 	 PN 	 Gine
malah 	 N 	 sailor
Guzayana 	 PN 	 Guzayana
gig 	 N 	 resin_type
nagar 	 N 	 carpenter
Nimgirane 	 PN 	 Nimgirane
Gamu 	 PN 	 Gamu
Lu'igi 	 PN 	 Lu'igi
Narnita 	 PN 	 Narnita
girsiga 	 N 	 attendant
Ninura 	 DN 	 1
kikken 	 N 	 miller
Uszkalimmu 	 DN 	 1
e'esir 	 N 	 house_of_bitumen
Lugalinimduga 	 PN 	 Lugalinimduga
gabus 	 N 	 shepherd_helper
_(ban) 	 N 	 unit
uggaga 	 N 	 porter
Apidingir 	 PN 	 Apidingir
Lugalme'a 	 PN 	 Lugalme'a
_(barig) 	 N 	 unit
Ayabbamu 	 PN 	 Ayabbamu
Sagku 	 PN 	 Sagku
ganun 	 N 	 storehouse
Gayame 	 PN 	 Gayame
Lugaldingira 	 PN 	 Lugaldingira
2(gesz'u) 	 NU 	 six_hundred
utul 	 N 	 tureen
usakar 	 N 	 crescent_moon
Kisura 	 N 	 border
utusza 	 N 	 holiday
Lubagara 	 PN 	 Lubagara
Ezembaba 	 MN 	 1
kiszib 	 N 	 sealed_tablet
Lugalnir 	 PN 	 Lugalnir
szusar 	 N 	 string
Sza'iri 	 PN 	 Sza'iri
kaskal 	 N 	 journey
Sabum 	 SN 	 1
Szu'enlil 	 PN 	 Szu'enlil
aga'usgal 	 N 	 head_soldier
Dadani 	 PN 	 Dadani
Elanu'id 	 PN 	 Elanu'id
Szukubum 	 PN 	 Szukubum
Szuszin 	 SN 	 1
ma 	 N 	 ship
An 	 DN 	 1
Nanaya 	 DN 	 1
esz 	 N 	 shrine
Gezal 	 DN 	 1
nigkizah 	 N 	 cult_offering
Abilati 	 PN 	 Abilati
giranum 	 N 	 wailing
Belatsuhner 	 DN 	 1
Belatdarraban 	 DN 	 1
Belidu 	 PN 	 Belidu
Sagdana 	 PN 	 Sagdana
Ahuwaqar 	 PN 	 Ahuwaqar
Erabi 	 PN 	 Erabi
Aneni 	 PN 	 Aneni
Gutabimumu 	 MN 	 1
Engalmahana 	 PN 	 Engalmahana
Harszi 	 SN 	 1
sig 	 N 	 class_of_worker
Girini'isa 	 PN 	 Girini'isa
Szekaragala 	 MN 	 1
zabar 	 N 	 measuring_vessel
Lugalhegal 	 PN 	 Lugalhegal
diri 	 N 	 intercalary_month
kaskal 	 N 	 travel_basket
Agu 	 PN 	 Agu
Szarahegal 	 PN 	 Szarahegal
Urisztaran 	 PN 	 Urisztaran
Lugaluszur 	 PN 	 Lugaluszur
Uramana 	 PN 	 Uramana
ennug 	 N 	 prison
Danupi 	 PN 	 Danupi
Adda 	 PN 	 Adda
Elam 	 EN 	 1
Arti'a 	 PN 	 Arti'a
Amurutu 	 PN 	 Amurutu
dabin 	 N 	 semolina
Erabani 	 PN 	 Erabani
Szulgirdangada 	 PN 	 Szulgirdangada
Urabzu 	 PN 	 Urabzu
Muszudu 	 MN 	 1
Muriqtidnim 	 ON 	 1
Urgesztinanka 	 PN 	 Urgesztinanka
Lu'abu 	 PN 	 Lu'abu
Adudu 	 PN 	 Adudu
szukur 	 N 	 prebend_land
Inimanizi 	 PN 	 Inimanizi
tir 	 N 	 forester
Uremasz 	 PN 	 Uremasz
Lugalhili 	 PN 	 Lugalhili
Urtulmah 	 PN 	 Urtulmah
Lugalzage 	 PN 	 Lugalzage
Szarakam 	 PN 	 Szarakam
Bayansa 	 PN 	 Bayansa
Habaluge 	 PN 	 Habaluge
Dugani 	 PN 	 Dugani
Luhegal 	 PN 	 Luhegal
Luga 	 PN 	 Luga
Szakuge 	 PN 	 Szakuge
Lalmes 	 PN 	 Lalmes
Abuda 	 PN 	 Abuda
Lusaga 	 PN 	 Lusaga
Abaszaragin 	 PN 	 Abaszaragin
Bali 	 PN 	 Bali
Urani 	 PN 	 Urani
Gidaha 	 FN 	 1
Lu'irisagki 	 PN 	 Lu'irisagki
Lugalgumah 	 PN 	 Lugalgumah
Laz 	 DN 	 1
Bibi'a 	 PN 	 Bibi'a
saggal 	 N 	 food
Urnanszeka 	 PN 	 Urnanszeka
ur 	 N 	 roof
e'uzga 	 N 	 building_type
Luninszubur 	 PN 	 Luninszubur
Lugalennun 	 PN 	 Lugalennun
Aba'enlilgin 	 PN 	 Aba'enlilgin
Duga 	 PN 	 Duga
Ezemmekigal 	 MN 	 1
Lana 	 PN 	 Lana
Urzu 	 PN 	 Urzu
naruamah 	 N 	 magnificent_stele
maszdanita 	 N 	 male_gazelle
maszdamunus 	 N 	 female_gazelle
Nannamaba 	 PN 	 Nannamaba
sagnigGArak 	 N 	 available_assets
Maszdagu 	 MN 	 1
esza 	 N 	 flour
Nalul 	 PN 	 Nalul
kunga 	 N 	 equid_type
Aba 	 PN 	 Aba
Unu 	 SN 	 1
imgaga 	 N 	 emmer
Lanimu 	 PN 	 Lanimu
siki 	 N 	 wool
Ezemmah 	 MN 	 1
Lugallusasa 	 PN 	 Lugallusasa
Karzida 	 SN 	 1
ummud 	 N 	 waterskin
esir 	 N 	 shoe
ib 	 N 	 middle
szugan 	 N 	 pot_type
duggan 	 N 	 leather_bag
Madaga 	 SN 	 1
3(gesz'u) 	 NU 	 six_hundred
Lamah 	 FN 	 1
Biduga 	 PN 	 Biduga
Atu 	 PN 	 Atu
Eana 	 TN 	 1
Urmami 	 PN 	 Urmami
GANmah 	 FN 	 1
Urenuna 	 PN 	 Urenuna
Hurti 	 SN 	 1
asz 	 NU 	 one
Szu'enlila 	 PN 	 Szu'enlila
lungak 	 N 	 brewer
Guzani 	 PN 	 Guzani
Ursaga 	 PN 	 Ursaga
Gula 	 DN 	 1
Namhani 	 PN 	 Namhani
sagi 	 N 	 cup_bearer
dub 	 N 	 tablet
Lu'igimasze 	 PN 	 Lu'igimasze
uszbar 	 N 	 weaver
GANmasz 	 MN 	 1
dabatum 	 N 	 textile_type
suGAN 	 N 	 metallurgical_material
Gayagaya 	 PN 	 Gayagaya
Utubara 	 PN 	 Utubara
Maszkugu 	 MN 	 1
Gayagagaya 	 PN 	 Gayagagaya
Heti 	 PN 	 Heti
Geparkidu 	 PN 	 Geparkidu
1(asz 	 NU 	 c)
Lugalutu 	 PN 	 Lugalutu
e'udu 	 N 	 sheephouse
girlam 	 N 	 basket_type
Ha'ia 	 DN 	 1
E'u15 	 TN 	 1
giba'a 	 N 	 midnight
eszesz 	 N 	 festival
Sesdagu 	 MN 	 1
badgal 	 N 	 great_wall
Lubaba 	 PN 	 Lubaba
Urbadtibira 	 PN 	 Urbadtibira
Szaszrum 	 SN 	 1
Lugalmumag 	 PN 	 Lugalmumag
guru 	 N 	 grain_heap
Saharu'u 	 SN 	 1
Simurum 	 SN 	 1
ikud 	 N 	 fish_oil
iba 	 N 	 oil_ration
Luniglagare 	 PN 	 Luniglagare
Dingira 	 PN 	 Dingira
sullim 	 N 	 spice_type
zidIL 	 N 	 flour_type
kataba 	 N 	 double_mouth
Lugaligihusz 	 PN 	 Lugaligihusz
GANAgud 	 FN 	 1
Ayabbani 	 PN 	 Ayabbani
E'ansze 	 FN 	 1
Abuka 	 FN 	 1
Naramsuen 	 RN 	 1
Udumulli 	 FN 	 1
Iribare 	 PN 	 Iribare
Urasarluhi 	 PN 	 Urasarluhi
Szulgirmiszar 	 PN 	 Szulgirmiszar
Iszkurkugal 	 PN 	 Iszkurkugal
Nannaludu 	 PN 	 Nannaludu
Unapszen 	 PN 	 Unapszen
Abilsuen 	 PN 	 Abilsuen
Aradnanna 	 PN 	 Aradnanna
Tultapada 	 PN 	 Tultapada
isz 	 N 	 flour_type
Urigalim 	 PN 	 Urigalim
Udaya 	 PN 	 Udaya
gagsum 	 N 	 arrow_type
imba 	 N 	 deficit
gagsisa 	 N 	 arrow
Dikumiszar 	 PN 	 Dikumiszar
Huba 	 PN 	 Huba
Puzuriszdagan 	 SN 	 1
Ubigu 	 MN 	 1
Anzubabbar 	 TN 	 1
Lugalanisa 	 PN 	 Lugalanisa
Lugalkiri 	 PN 	 Lugalkiri
etur 	 N 	 stall
gudapin 	 N 	 plow_ox
Szu'eszdar 	 PN 	 Szu'eszdar
Addamu 	 PN 	 Addamu
Gududu 	 PN 	 Gududu
Luszalim 	 PN 	 Luszalim
Nindingir 	 PN 	 Nindingir
ama 	 N 	 mother
Enlilmu 	 PN 	 Enlilmu
karkimura 	 N 	 habour_of_depository
Dingirsudan 	 PN 	 Dingirsudan
Urszuzi'andul 	 PN 	 Urszuzi'andul
Szarabansa 	 PN 	 Szarabansa
Enrakal 	 PN 	 Enrakal
min 	 NU 	 two
Lugalzagesi 	 PN 	 Lugalzagesi
Ursagamu 	 PN 	 Ursagamu
Uramma 	 PN 	 Uramma
Lugalsa'izu 	 PN 	 Lugalsa'izu
Kaguru 	 PN 	 Kaguru
Ipa'e 	 PN 	 Ipa'e
elungak 	 N 	 brewery
situm 	 N 	 balance
gu 	 N 	 cord
kikken 	 N 	 millstone
Abala 	 FN 	 1
Urmeme 	 PN 	 Urmeme
Kazallu 	 SN 	 1
E'u'e 	 PN 	 E'u'e
Kisikininazu 	 MN 	 1
Liburszulgir 	 PN 	 Liburszulgir
Utuhesa 	 PN 	 Utuhesa
Szulgirmudah 	 PN 	 Szulgirmudah
Kudanum 	 PN 	 Kudanum
Amamaya 	 PN 	 Amamaya
Szumam 	 PN 	 Szumam
Ekikkengibil 	 GN 	 1
Me'isztaran 	 PN 	 Me'isztaran
Puzurenlil 	 PN 	 Puzurenlil
Kubatum 	 PN 	 Kubatum
nin 	 N 	 lady
Ereszum 	 PN 	 Ereszum
Szu'iszkur 	 PN 	 Szu'iszkur
Urlugalbanda 	 PN 	 Urlugalbanda
Ahuwer 	 PN 	 Ahuwer
Enkik 	 DN 	 1
mug 	 N 	 inferior_wool
imbabbar 	 N 	 gypsum
ga 	 N 	 house
munus 	 N 	 woman
Maszdagula 	 PN 	 Maszdagula
nigsam 	 N 	 price
Urenlila 	 PN 	 Urenlila
Urababa 	 PN 	 Urababa
Kudamu 	 PN 	 Kudamu
zadim 	 N 	 stone_cutter
Lu'enlila 	 PN 	 Lu'enlila
Lugalmeduga 	 PN 	 Lugalmeduga
Lugalibila 	 PN 	 Lugalibila
Kuza 	 PN 	 Kuza
Szarrumbani 	 PN 	 Szarrumbani
Puttuli'um 	 SN 	 1
Ibniszulgir 	 PN 	 Ibniszulgir
gun 	 N 	 tribute
udugi 	 N 	 native_sheep
Gu'abba 	 SN 	 1
izigu 	 N 	 loss
Uszmu 	 PN 	 Uszmu
szenumun 	 N 	 seed
murgu 	 N 	 fodder
Da'umma 	 SN 	 1
5(bur) 	 N 	 unit
kisur 	 N 	 threshing_floor
Kamari 	 FN 	 1
Damsa 	 PN 	 Damsa
namszatam 	 N 	 administration
Szu'utu 	 PN 	 Szu'utu
geszi 	 N 	 sesame
Bibi 	 PN 	 Bibi
Annunitum 	 PN 	 Annunitum
Ulmaszitum 	 DN 	 1
rubatum 	 N 	 princess
Lu'uru 	 PN 	 Lu'uru
Ayatti'a 	 PN 	 Ayatti'a
szesz 	 N 	 brother
Zu'al 	 PN 	 Zu'al
Errebum 	 PN 	 Errebum
Hunnarum 	 PN 	 Hunnarum
kugsig 	 N 	 gold
Ali 	 PN 	 Ali
Bikkinum 	 PN 	 Bikkinum
Ursudda 	 PN 	 Ursudda
Munasi 	 PN 	 Munasi
Bu'unum 	 PN 	 Bu'unum
Ursuddame 	 PN 	 Ursuddame
tukul 	 N 	 weapon
Enurkuge 	 PN 	 Enurkuge
szudu'a 	 N 	 guarantee
szunir 	 N 	 emblem
zabar 	 N 	 bronze
ugu 	 N 	 top
szengamebur 	 N 	 metal_bowl_type
murub 	 N 	 middle
aga 	 N 	 tiara
egir 	 N 	 back
bulug 	 N 	 needle
sagkul 	 N 	 bolt
nigluh 	 N 	 basin
kudu 	 N 	 metal_vessel_type
kugan 	 N 	 metal_type
Ninilduma 	 PN 	 Ninilduma
Geme'aszar 	 PN 	 Geme'aszar
kir 	 N 	 female_lamb
gude'usa 	 N 	 lowest_quality
Ninegal 	 DN 	 1
aszgar 	 N 	 female_kid
Suenabuszu 	 PN 	 Suenabuszu
ki'anag 	 N 	 place_of_libations
lukur 	 N 	 priestess
Amurdingir 	 PN 	 Amurdingir
agiba 	 N 	 midnight
Kugnanna 	 PN 	 Kugnanna
ka'usa 	 N 	 profession_type
2(disz 	 NU 	 t)
Karkinna 	 SN 	 1
Anamu 	 PN 	 Anamu
Lugalkigala 	 PN 	 Lugalkigala
Nitasaga 	 PN 	 Nitasaga
Amarayasi 	 MN 	 1
Urtur 	 PN 	 Urtur
guzala 	 N 	 throne_bearer
Tulta 	 PN 	 Tulta
kila 	 N 	 size
nigena 	 N 	 property_type
Layasa 	 PN 	 Layasa
mun 	 N 	 salt
Gu'edina 	 SN 	 1
kugdim 	 N 	 smith
armatum 	 N 	 door
dus 	 N 	 path
Lunanna 	 PN 	 Lunanna
Lu'inanna 	 PN 	 Lu'inanna
Nuraya 	 PN 	 Nuraya
Urnungal 	 PN 	 Urnungal
Narame'a 	 PN 	 Narame'a
szarrabdu 	 N 	 administrator
Mudasa 	 PN 	 Mudasa
Szulgirili 	 PN 	 Szulgirili
Sze'ila 	 MN 	 1
munu 	 N 	 malt
Magure 	 PN 	 Magure
Lulubum 	 SN 	 1
Egesztin 	 PN 	 Egesztin
Urpagara 	 PN 	 Urpagara
Dugamu 	 PN 	 Dugamu
Lugalnignesage 	 PN 	 Lugalnignesage
Utamiszaram 	 PN 	 Utamiszaram
Ennu 	 PN 	 Ennu
Szuszulgir 	 PN 	 Szuszulgir
Tabbeli 	 PN 	 Tabbeli
Dannum 	 PN 	 Dannum
Idi'a 	 PN 	 Idi'a
SIGa 	 PN 	 SIGa
Puzursuen 	 PN 	 Puzursuen
Lu'ume 	 PN 	 Lu'ume
Uburli 	 PN 	 Uburli
Lubalasa 	 PN 	 Lubalasa
Allatum 	 DN 	 1
Endimgi 	 SN 	 1
Abisimti 	 PN 	 Abisimti
Nannakam 	 PN 	 Nannakam
szu'i 	 N 	 barber
Sagine 	 PN 	 Sagine
maszda 	 N 	 stone
mar 	 N 	 wagon
kunzida 	 N 	 weir
Sisa 	 WN 	 1
Ga'esz 	 SN 	 1
Szulgirayamu 	 PN 	 Szulgirayamu
Nigbaba 	 PN 	 Nigbaba
engargusuhub 	 N 	 farmer
Iszkurillat 	 PN 	 Iszkurillat
Akuku 	 PN 	 Akuku
Puzurgaga 	 PN 	 Puzurgaga
Dingirrabi 	 PN 	 Dingirrabi
Kuni 	 PN 	 Kuni
Danu'a 	 PN 	 Danu'a
Zayanum 	 PN 	 Zayanum
Nurili 	 PN 	 Nurili
Szu'u'a 	 PN 	 Szu'u'a
Geszirminra 	 PN 	 Geszirminra
Enumiszkur 	 PN 	 Enumiszkur
Elaknu'id 	 PN 	 Elaknu'id
Szu'abba 	 PN 	 Szu'abba
Dingirbani 	 PN 	 Dingirbani
Inaszum 	 PN 	 Inaszum
Elakkuruba 	 PN 	 Elakkuruba
Maszkan 	 SN 	 1
Dudu 	 SN 	 1
Ebkusza 	 PN 	 Ebkusza
Maszgula 	 PN 	 Maszgula
Lugaluszumgal 	 PN 	 Lugaluszumgal
Urbaya 	 PN 	 Urbaya
Lugirizal 	 PN 	 Lugirizal
Abuni 	 PN 	 Abuni
Maszkanszabra 	 SN 	 1
ta 	 N 	 unknown
Lugalme 	 PN 	 Lugalme
Erzudan 	 PN 	 Erzudan
Urzikuma 	 PN 	 Urzikuma
Ili'etu 	 PN 	 Ili'etu
Lagip 	 PN 	 Lagip
Isin 	 SN 	 1
Adaszen 	 PN 	 Adaszen
E'erdingir 	 PN 	 E'erdingir
Szuruppak 	 SN 	 1
Ure'anna 	 PN 	 Ure'anna
Erreb 	 PN 	 Erreb
Ili'ahum 	 PN 	 Ili'ahum
Szu'iliszu 	 PN 	 Szu'iliszu
masznita 	 N 	 male_goat
Szulgirzimu 	 PN 	 Szulgirzimu
Szu'era 	 PN 	 Szu'era
Igisasa 	 PN 	 Igisasa
Kituszlu 	 PN 	 Kituszlu
Urgu'edina 	 PN 	 Urgu'edina
Szunukusz 	 PN 	 Szunukusz
Zuzu'a 	 PN 	 Zuzu'a
Bahanszer 	 PN 	 Bahanszer
Guratir 	 PN 	 Guratir
itud 	 N 	 worker_category
Szara'amu 	 PN 	 Szara'amu
Zage 	 PN 	 Zage
Adaga 	 PN 	 Adaga
Gugad 	 PN 	 Gugad
Szarabazige 	 PN 	 Szarabazige
UDISZ 	 PN 	 UDISZ
Gemesuen 	 PN 	 Gemesuen
Siguszubagar 	 MN 	 1
urzir 	 N 	 tree_type
Dingirsurabi 	 PN 	 Dingirsurabi
Luninura 	 PN 	 Luninura
Ikala 	 PN 	 Ikala
Lusukkalankak 	 PN 	 Lusukkalankak
Bamu 	 PN 	 Bamu
Gululu 	 PN 	 Gululu
Urbil 	 PN 	 Urbil
Szumana 	 PN 	 Szumana
Aradszara 	 PN 	 Aradszara
simug 	 N 	 smith
Urninmuga 	 PN 	 Urninmuga
Dukusig 	 FN 	 1
zir 	 N 	 slip
tugba 	 N 	 textile_distribution
Eszara 	 TN 	 1
Lugalmudra 	 PN 	 Lugalmudra
Urkigulame 	 PN 	 Urkigulame
Lunindara 	 PN 	 Lunindara
abba 	 N 	 elder
Luha'ia 	 PN 	 Luha'ia
dumu 	 N 	 son
Lunansze 	 PN 	 Lunansze
Nimgirinimgina 	 PN 	 Nimgirinimgina
Lugalinimgina 	 PN 	 Lugalinimgina
Nimgirdine 	 PN 	 Nimgirdine
Luhendursag 	 PN 	 Luhendursag
Szagana 	 PN 	 Szagana
Urenlilak 	 PN 	 Urenlilak
Lugalukkene 	 PN 	 Lugalukkene
Ursu'anak 	 PN 	 Ursu'anak
Urszakkan 	 PN 	 Urszakkan
Mese 	 PN 	 Mese
Naramili 	 PN 	 Naramili
idu 	 N 	 doorkeeper
Gi'apinkudra 	 FN 	 1
Iszkurbani 	 PN 	 Iszkurbani
Iszarpadan 	 PN 	 Iszarpadan
Urninmug 	 PN 	 Urninmug
zulum 	 N 	 date
ga'ar 	 N 	 cheese
igu 	 N 	 flax_oil
dubdub 	 N 	 flour_designation
Szeszani 	 PN 	 Szeszani
na 	 N 	 stone_weight
Ea 	 ON 	 1
geszkigti 	 N 	 workshop
Ursagku 	 PN 	 Ursagku
Puzurenlila 	 PN 	 Puzurenlila
E'iluruguda 	 PN 	 E'iluruguda
gugala 	 N 	 chickpea
Ayamu 	 PN 	 Ayamu
Agiwum 	 ON 	 1
UtuGIRgal 	 PN 	 UtuGIRgal
Szarrumili 	 PN 	 Szarrumili
Liszena 	 PN 	 Liszena
suhub 	 N 	 boots
Addada 	 PN 	 Addada
Sa'a 	 ON 	 1
SZIM 	 N 	 beer_malt
szeli 	 N 	 aromatics
Hababatum 	 PN 	 Hababatum
lal 	 N 	 syrup
gesztin 	 N 	 vine
ba 	 N 	 animal
Luyenlil 	 PN 	 Luyenlil
dukug 	 N 	 locus
pesz 	 N 	 fig
szergu 	 N 	 string
usuh 	 N 	 tree
gimusz 	 N 	 pole
kabkul 	 N 	 container
Lugalebansa 	 PN 	 Lugalebansa
allaharu 	 N 	 unknown
Elubisu 	 PN 	 Elubisu
4(disz 	 NU 	 v)
Pada 	 PN 	 Pada
Ahuya 	 PN 	 Ahuya
Ninturturra 	 PN 	 Ninturturra
Watarum 	 PN 	 Watarum
Burmama 	 PN 	 Burmama
Idda'a 	 PN 	 Idda'a
Urum 	 SN 	 1
geszdu 	 N 	 breeder
Szimaszgi 	 N 	 Szimaszkian
Adalal 	 PN 	 Adalal
Puzurnanna 	 PN 	 Puzurnanna
Luningirsu 	 PN 	 Luningirsu
Sagub 	 SN 	 1
Urszuszbaba 	 PN 	 Urszuszbaba
Egibile 	 FN 	 1
Hurbiszam 	 PN 	 Hurbiszam
SI'Aya 	 PN 	 SI'Aya
geszdu 	 N 	 breeding_stock
Szu'igidu 	 N 	 advance_payment
Abbamu 	 PN 	 Abbamu
Ninkunun 	 TN 	 1
nigezema 	 N 	 festival_material
Namirina 	 PN 	 Namirina
Agugu 	 PN 	 Agugu
Nadatum 	 PN 	 Nadatum
nigmussa 	 N 	 gift
Hanzabtum 	 PN 	 Hanzabtum
1 	 PN 	 1
1 	 PN 	 1
1(barig) 	 N 	 unit
Etena 	 GN 	 1
lulum 	 N 	 sheep_designation
szimaszigi 	 N 	 sheep_designation
Zubaga 	 PN 	 Zubaga
Lugalidi 	 PN 	 Lugalidi
dusu 	 N 	 donkey
ennug 	 N 	 guard
Kira 	 SN 	 1
Hemadu 	 PN 	 Hemadu
nukirik 	 N 	 gardener
Dadu 	 PN 	 Dadu
Zamu 	 PN 	 Zamu
gesznimbar 	 N 	 palm
apinla 	 N 	 tiller
kabur 	 N 	 profession
Kayamu 	 PN 	 Kayamu
nakabtum 	 N 	 stockyard
Ninnudu 	 FN 	 1
Dadumu 	 PN 	 Dadumu
dam 	 N 	 spouse
Danni'a 	 PN 	 Danni'a
Allagula 	 DN 	 1
Ninegi'a 	 DN 	 1
E'u7 	 ON 	 1
Ninga 	 PN 	 Ninga
DIRI 	 PN 	 DIRI
Libursimti 	 PN 	 Libursimti
Zusi 	 MN 	 1
3(disz) 	 NU 	 3(disz)
ennug 	 N 	 watch
Kusaga 	 PN 	 Kusaga
gizi 	 N 	 reed
Meslamta'e'a 	 PN 	 Meslamta'e'a
Lagasz 	 SN 	 1
namtil 	 N 	 life
gesztug 	 N 	 wisdom
nigsaga 	 N 	 goodness
Niridagal 	 PN 	 Niridagal
Szulgisi'imtum 	 PN 	 Szulgisi'imtum
Allamu 	 PN 	 Allamu
Lugaluri 	 PN 	 Lugaluri
Szulgi'abi 	 PN 	 Szulgi'abi
Enunugalinanna 	 PN 	 Enunugalinanna
szagud 	 N 	 ox_driver
dumugugur 	 N 	 worker
Ezemlisi 	 MN 	 1
gipar 	 N 	 cloister
atua 	 N 	 lustration
Kisuen 	 SN 	 1
szimaszki 	 N 	 sheep_designation
Kaszuba 	 GN 	 1
Lugalbanda 	 DN 	 1
Ningeszzida 	 DN 	 1
Nerahagal 	 DN 	 1
1 	 DN 	 1
udtena 	 N 	 evening
1 	 DN 	 1
1 	 DN 	 1
Ninazu 	 DN 	 1
Enegi 	 SN 	 1
du 	 N 	 ur
dublamah 	 TN 	 magnificent_tower
A'anda 	 DN 	 1
Ningal 	 DN 	 1
Ningubalag 	 DN 	 1
Ninsun 	 DN 	 1
Ninszagepada 	 DN 	 1
Alamusz 	 DN 	 1
Muri'anabak 	 SN 	 1
guru 	 N 	 store
Halli'a 	 PN 	 Halli'a
Nininimgina 	 PN 	 Nininimgina
Nuhilum 	 PN 	 Nuhilum
Urgug 	 PN 	 Urgug
Igiszarasze 	 PN 	 Igiszarasze
Sze'illa 	 MN 	 1
Kinunir 	 SN 	 1
Kimadasalla 	 SN 	 1
muhaldim 	 N 	 cook
amaru 	 N 	 flood
garig 	 N 	 comb
Dingirra 	 PN 	 Dingirra
kiszig 	 N 	 acacia
Emakidug 	 PN 	 Emakidug
Tur 	 FN 	 1
Igigallugaluru 	 SN 	 1
nindan 	 N 	 pole
imdua 	 N 	 wall
gidua 	 N 	 fence
baragsiga 	 N 	 shrine
Ninmar 	 SN 	 1
geszkesz 	 N 	 dam
gidua 	 N 	 reed_fence
Esarradu 	 SN 	 1
Nanszegarra 	 DN 	 1
gudgesz 	 N 	 draught_ox
Abbakala 	 PN 	 Abbakala
Latur 	 FN 	 1
Haszipatal 	 PN 	 Haszipatal
Ganmasz 	 MN 	 1
Ezemdumuzi 	 MN 	 1
Dingiradah 	 PN 	 Dingiradah
Su'enbani 	 PN 	 Su'enbani
Szulgiszamszi 	 PN 	 Szulgiszamszi
Puzuraszur 	 PN 	 Puzuraszur
Abillatum 	 PN 	 Abillatum
Agu'a 	 PN 	 Agu'a
eban 	 N 	 pair
Garszana 	 SN 	 1
Eludan 	 PN 	 Eludan
Lugalamgal 	 PN 	 Lugalamgal
mer 	 N 	 north
kur 	 N 	 east
Luningaka 	 PN 	 Luningaka
nigin 	 N 	 bundle
gaz 	 N 	 type_of_garlic
numun 	 N 	 seed
igara 	 N 	 dairy
Erragar 	 PN 	 Erragar
Szuszumudar 	 PN 	 Szuszumudar
Turamili 	 PN 	 Turamili
Szu'ili 	 PN 	 Szu'ili
Kirsi'ak 	 MN 	 1
imkusig 	 N 	 orpiment
sagkesz 	 N 	 state
nigmussa 	 N 	 bride
Nigdugani 	 PN 	 Nigdugani
Ibi 	 RN 	 Suen
esztub 	 N 	 carp
Ninmelam 	 PN 	 Ninmelam
Ekigal 	 PN 	 Ekigal
bala 	 N 	 turn
Urszakidu 	 PN 	 Urszakidu
Erradan 	 PN 	 Erradan
Urha'ia 	 PN 	 Urha'ia
Kuranisa 	 PN 	 Kuranisa
Szulgidangada 	 PN 	 Szulgidangada
Gu 	 AN 	 edina
ara 	 N 	 part_of_boat
kagir 	 N 	 reed_mat
szerrum 	 N 	 mat
su 	 N 	 body
szagra 	 N 	 lining
magur 	 N 	 barge
Szaragugal 	 PN 	 Szaragugal
bunig 	 N 	 trough
bariga 	 N 	 unit
Ninurta 	 DN 	 1
Nusku 	 DN 	 1
Ninti'uga 	 DN 	 1
Ninszubur 	 DN 	 1
Ninhursagak 	 DN 	 1
Inimzuharakal 	 PN 	 Inimzuharakal
Hunhurti 	 PN 	 Hunhurti
Zuzu 	 PN 	 Zuzu
Maszum 	 PN 	 Maszum
Szubaxgal 	 PN 	 Szubaxgal
Indada 	 PN 	 Indada
Arsziah 	 PN 	 Arsziah
Maszkanuszure 	 SN 	 1
Lugalpa 	 PN 	 Lugalpa
Siram 	 PN 	 Siram
Sagnannazu 	 PN 	 Sagnannazu
Zarig 	 PN 	 Zarig
Kuramu 	 PN 	 Kuramu
Ginuna 	 PN 	 Ginuna
Iddaya 	 PN 	 Iddaya
kaguruk 	 N 	 supervisor
Zinana 	 PN 	 Zinana
Bubu 	 PN 	 Bubu
ina 	 N 	 unknown
anigin 	 N 	 reservoir
nemur 	 N 	 ashes
gesz 	 N 	 barrage
Puzurninkarak 	 PN 	 Puzurninkarak
szegeszi 	 N 	 sesame_seed
Uraba 	 PN 	 Uraba
Iline 	 PN 	 Iline
Huwawa 	 PN 	 Huwawa
uda 	 N 	 day
Gani 	 SN 	 1
Urningeszzida 	 PN 	 Urningeszzida
Nansze 	 DN 	 1
Lu'irisag 	 PN 	 Lu'irisag
Nannahili 	 PN 	 Nannahili
Urebabbar 	 PN 	 Urebabbar
Gadu 	 PN 	 Gadu
Alla 	 PN 	 Alla
tibala 	 N 	 portent
Lugalmaszzu 	 PN 	 Lugalmaszzu
enkud 	 N 	 tax_collector
1 	 PN 	 1
Adu 	 PN 	 Adu
Turtura 	 PN 	 Turtura
Meniku 	 PN 	 Meniku
Igisusu 	 PN 	 Igisusu
Ninkuzu 	 PN 	 Ninkuzu
Szayatmami 	 PN 	 Szayatmami
Gemenigar 	 PN 	 Gemenigar
Ninkurma 	 PN 	 Ninkurma
Ninadda 	 PN 	 Ninadda
Gemegigir 	 PN 	 Gemegigir
Ninensa 	 PN 	 Ninensa
Me 	 PN 	 Me
Szagubi 	 PN 	 Szagubi
Kina 	 PN 	 Kina
Ninebayansa 	 PN 	 Ninebayansa
Geme 	 PN 	 Geme
Ninkusig 	 PN 	 Ninkusig
Amakala 	 PN 	 Amakala
Ninnammahzu 	 PN 	 Ninnammahzu
Ninme 	 PN 	 Ninme
Ninegale 	 PN 	 Ninegale
Mamihilisu 	 PN 	 Mamihilisu
Gemedubla 	 PN 	 Gemedubla
Ninagrigzi 	 PN 	 Ninagrigzi
Amagina 	 PN 	 Amagina
Gemedumuzida 	 PN 	 Gemedumuzida
Igi 	 PN 	 Igi
Amawurszage 	 PN 	 Amawurszage
Agalzi 	 PN 	 Agalzi
Munussaga 	 PN 	 Munussaga
Ningina 	 PN 	 Ningina
Gemeszara 	 PN 	 Gemeszara
Geme 	 PN 	 Geme
Lukurkala 	 PN 	 Lukurkala
Ninkuli 	 PN 	 Ninkuli
Ninzagesi 	 PN 	 Ninzagesi
Lukurkalla 	 PN 	 Lukurkalla
Gemeszulpa 	 PN 	 Gemeszulpa
Kisikil 	 PN 	 Kisikil
Geme 	 PN 	 Geme
Me 	 PN 	 Me
Gemelisi 	 PN 	 Gemelisi
Geme 	 PN 	 Geme
Geme 	 PN 	 Geme
Lugalisa 	 PN 	 Lugalisa
Ama 	 PN 	 Ama
Inimmadingir 	 PN 	 Inimmadingir
Ninmagurre 	 PN 	 Ninmagurre
Urnumuszda 	 PN 	 Urnumuszda
Namninanidu 	 PN 	 Namninanidu
Geme 	 PN 	 Geme
Elulagar 	 PN 	 Elulagar
Ninbatukuszemduga 	 PN 	 Ninbatukuszemduga
za 	 N 	 unknown
uzu 	 N 	 body
gu 	 N 	 neck
Bala 	 PN 	 Bala
Manszum 	 PN 	 Manszum
Luszulgir 	 PN 	 Luszulgir
KA 	 N 	 flour
Kunansze 	 PN 	 Kunansze
Ennunne 	 PN 	 Ennunne
Nimgirszakuszanna 	 PN 	 Nimgirszakuszanna
A'annati 	 PN 	 A'annati
Ilisa 	 PN 	 Ilisa
Lugalhamati 	 PN 	 Lugalhamati
Sigiszubgar 	 MN 	 1
Urdubla 	 PN 	 Urdubla
aszgabgal 	 N 	 head_leatherworker
gi 	 N 	 thicket
Lila 	 PN 	 Lila
Urdun 	 PN 	 Urdun
Igbidingir 	 PN 	 Igbidingir
szuszuma 	 N 	 consignment
e'uszbar 	 N 	 textile_workshop
Lani 	 PN 	 Lani
Dingirga'isa 	 PN 	 Dingirga'isa
Hamati 	 PN 	 Hamati
Anita 	 PN 	 Anita
Addakala 	 PN 	 Addakala
Szu'admu 	 PN 	 Szu'admu
Ludamu 	 PN 	 Ludamu
Urszenamnuntu 	 PN 	 Urszenamnuntu
Kudadu 	 PN 	 Kudadu
Bilga 	 PN 	 Bilga
Katar 	 PN 	 Katar
Lugallama 	 PN 	 Lugallama
Sisini 	 PN 	 Sisini
Azida 	 PN 	 Azida
Sigga 	 MN 	 1
dul 	 N 	 shade
Urgepar 	 PN 	 Urgepar
tukumbi 	 CNJ 	 if
Beli 	 PN 	 Beli
Szatakuzu 	 PN 	 Szatakuzu
Urlugal 	 PN 	 Urlugal
Allapalil 	 PN 	 Allapalil
tugba 	 N 	 textile_ration
ega 	 N 	 dairy
Ala 	 PN 	 Ala
Enamgalanna 	 PN 	 Enamgalanna
Idinerra 	 PN 	 Idinerra
Luhurim 	 PN 	 Luhurim
Luna 	 PN 	 Luna
Ezemlisina 	 MN 	 1
Dagamu 	 PN 	 Dagamu
Szeszszesz 	 PN 	 Szeszszesz
Madaya 	 PN 	 Madaya
siki'ud 	 N 	 goat_wool
gina 	 N 	 dues
Szu'ene 	 PN 	 Szu'ene
Enmahganna 	 SN 	 1
1 	 PN 	 1
Nigkala 	 PN 	 Nigkala
Anne 	 PN 	 Anne
Szegbar 	 PN 	 Szegbar
Bugati 	 PN 	 Bugati
Idi'iszkur 	 PN 	 Idi'iszkur
al 	 N 	 hoeing
anna 	 N 	 tin
Luhabilum 	 PN 	 Luhabilum
Lugalirida 	 PN 	 Lugalirida
ug 	 N 	 people
dumugi 	 N 	 citizen
Egalesi 	 PN 	 Egalesi
5(gesz'u) 	 NU 	 six_hundred
Amarkiszi 	 PN 	 Amarkiszi
Gudena 	 PN 	 Gudena
Nimgirdide 	 PN 	 Nimgirdide
4(gesz'u) 	 NU 	 six_hundred
Lumagure 	 PN 	 Lumagure
Edi 	 PN 	 Edi
nu'eszak 	 N 	 priest
Ennunki 	 PN 	 Ennunki
Suhgibildu'a 	 WN 	 1
szuluh 	 N 	 ritual_cleansing
Gu'ugu'a 	 PN 	 Gu'ugu'a
munsub 	 N 	 shepherd
Gigire 	 PN 	 Gigire
Matilum 	 PN 	 Matilum
Lumelam 	 PN 	 Lumelam
Damu 	 PN 	 Damu
szandana 	 N 	 gardener
Annebabdu 	 PN 	 Annebabdu
Puzurili 	 PN 	 Puzurili
Lugalszudari 	 PN 	 Lugalszudari
Lugalamu 	 PN 	 Lugalamu
Hulal 	 PN 	 Hulal
szakkanak 	 N 	 general
Girini'idab 	 PN 	 Girini'idab
Sigarha 	 PN 	 Sigarha
Uraya 	 PN 	 Uraya
gasze'a 	 N 	 sour_milk
Duge 	 PN 	 Duge
Ididingir 	 PN 	 Ididingir
Nakiki 	 PN 	 Nakiki
Titi 	 PN 	 Titi
Szunirruku 	 PN 	 Szunirruku
sag 	 N 	 head
Szarazame 	 PN 	 Szarazame
muru 	 N 	 mat
ur 	 N 	 yoked_team
Urdagi 	 PN 	 Urdagi
Lugalmassu 	 PN 	 Lugalmassu
Ambar 	 SN 	 1
Baddari 	 PN 	 Baddari
Nabax 	 PN 	 Nabax
apinla 	 N 	 tenancy
Ata 	 PN 	 Ata
Lulu 	 PN 	 Lulu
Andagudu'eszeki'ag 	 PN 	 Andagudu'eszeki'ag
Lusu 	 PN 	 Lusu
Szalimbeli 	 PN 	 Szalimbeli
Aradhula 	 PN 	 Aradhula
gabra 	 N 	 rider
Szugarra 	 MN 	 1
szag 	 N 	 inner_body
marsa 	 N 	 military_depot
Niglagare 	 PN 	 Niglagare
Lugalgaba 	 PN 	 Lugalgaba
Szuea 	 PN 	 Szuea
Ninhedu 	 PN 	 Ninhedu
Urgu 	 PN 	 Urgu
Kurbilak 	 PN 	 Kurbilak
Utubani 	 PN 	 Utubani
Szumamitum 	 PN 	 Szumamitum
E'abani 	 PN 	 E'abani
adda 	 N 	 father
Ennirgalanna 	 PN 	 Ennirgalanna
kar 	 N 	 harbor
Huhunuri 	 SN 	 1
sikikurra 	 N 	 type_of_wool
Urnintu 	 PN 	 Urnintu
tugmah 	 N 	 ceremonial_garment
tul 	 N 	 ditch
szegin 	 N 	 paint
egesz 	 N 	 workshop
Nigin 	 SN 	 1
kuda 	 PN 	 kuda
Giribaba 	 PN 	 Giribaba
Urigizibarra 	 PN 	 Urigizibarra
Urmah 	 N 	 1
gigir 	 N 	 chariot
Emah 	 TN 	 1
SZU 	 N 	 bread_type

*****VERB DICT*******

usz 	V	 die
hulu 	V	 destroy
teg 	V	 accept
hug 	V	 hire
du 	V	 build
gar 	V	 claim
me 	V	 be
szum 	V	 give
dug 	V	 speak
tar 	V	 ask
zu 	V	 know
gin 	V	 comfirm
du 	V	 hold
dab 	V	 seize
zal 	V	 pass
la 	V	 weigh
gen 	V	 go
du 	V	 caulk
gal 	V	 be
dim 	V	 create
zig 	V	 expend
mu 	V	 unknown
pad 	V	 find
gar 	V	 place
gid 	V	 survey
kur 	V	 enter
hun 	V	 hire
taka 	V	 abandon
sa 	V	 pay_for
pad 	V	 name
sig 	V	 harness
gub 	V	 pledge
de 	V	 bring
ak 	V	 present
til 	V	 live
gur 	V	 return
gu 	V	 eat
sa 	V	 sell
ag 	V	 measure
szesz 	V	 anoint
tuku 	V	 acquire
gi 	V	 return
ru 	V	 dedicate

*****END FLEXION*******

<ABS>:{ø}
<MID>:{ba}
<3-SG-S>:{ø}
<GEN>:{ak}
<ABL>:{ta}
<L1>:{'a}
<COP-3-SG>:{am}
<ERG>:{e}
<L3-NH>:{e}
<3-SG-H-A>:{n}
<3-SG-P>:{ø}
<3-SG-NH-POSS>:{bi}
<DAT-H>:{ra}
<2-SG-POSS>:{zu}
<L2-NH>:{'a}
<FIN>:{i}
<3-SG-H>:{nn}
<L2>:{i}
<SUB>:{a}
<1-SG-POSS>:{gu}
<TERM>:{sze}
<DAT-NH>:{e}
<VEN>:{mu}
<DAT>:{a}
<3-SG-NH-P>:{b}
<3-SG-A>:{e}
<COP-3-PL>:{mesz}
<3-SG-NH>:{b}
<L3>:{i}
<3-PL-DAT>:{nne}
<NEG>:{nu}
<3-PL>:{esz}
<ANT>:{u}
<2-SG-A>:{e}
<MOD>:{nan}
<PF>:{ed}
<3-PL>:{nnee}
<COM>:{da}
<VEN>:{m}
<3-SG-NH-L3>:{b}
<L1>:{ni}
<PL>:{ene}
<3-SG-H-DAT>:{nna}
<L1-SYN>:{n}
<3-SG-H-POSS>:{bi}
<DEM2>:{bi}
<3-SG-H-POSS>:{ani}
<3-NH>:{b}
<TERM>:{szi}
<L1>:{’a}
<3-SG-COP>:{am}
<MOD>:{ga}
<3-SG-DAT>:{nna}
<MOD>:{ha}
<3-SG-NH-A>:{b}
<3-SG-HN-P>:{b}

No. of Nouns: 1600 Verbs: 43 Ends: 56
